CustomerID,Frequency,Monetery,Recency,F_SCORE,M_SCORE,R_SCORE,RFM_SCORE,segment
12346,1,77183.6,326,1,5,1,7,SomeWhat Loyal
12347,7,4310.0,2,5,5,5,15,Champion
12348,4,1797.24,75,4,4,2,10,Loyal
12349,1,1757.55,19,1,4,4,9,Loyal
12350,1,334.4,310,1,2,1,4,Others
12352,8,2506.04,36,5,5,3,13,Champion
12353,1,89.0,204,1,1,1,3,LOST
12354,1,1079.4,232,1,4,1,6,SomeWhat Loyal
12355,1,459.4,214,1,2,1,4,Others
12356,3,2811.43,23,3,5,4,12,Loyal
12357,1,6207.67,33,1,5,4,10,Loyal
12358,2,1168.06,2,2,4,5,11,Loyal
12359,4,6372.58,58,4,5,3,12,Loyal
12360,3,2662.06,52,3,5,3,11,Loyal
12361,1,189.9,287,1,1,1,3,LOST
12362,10,5226.23,3,5,5,5,15,Champion
12363,2,552.0,110,2,3,2,7,SomeWhat Loyal
12364,4,1313.1,8,4,4,5,13,Champion
12365,2,641.38,291,2,3,1,6,SomeWhat Loyal
12367,1,168.9,4,1,1,5,7,SomeWhat Loyal
12370,4,3545.69,51,4,5,3,12,Loyal
12371,2,1887.96,45,2,4,3,9,Loyal
12372,3,1298.04,72,3,4,3,10,Loyal
12373,1,364.6,311,1,2,1,4,Others
12374,1,742.9300000000001,25,1,3,4,8,SomeWhat Loyal
12375,2,457.5,11,2,2,5,9,Loyal
12377,2,1628.12,315,2,4,1,7,SomeWhat Loyal
12378,1,4008.62,130,1,5,2,8,SomeWhat Loyal
12379,2,852.24,82,2,3,2,7,SomeWhat Loyal
12380,4,2724.81,22,4,5,4,13,Champion
12381,5,1845.31,5,4,4,5,13,Champion
12383,5,1850.56,185,4,4,1,9,Loyal
12384,2,585.27,29,2,3,4,9,Loyal
12386,2,401.9,338,2,2,1,5,SomeWhat Loyal
12388,6,2780.66,16,4,5,4,13,Champion
12390,1,549.84,80,1,3,2,6,SomeWhat Loyal
12391,1,460.89,22,1,2,4,7,SomeWhat Loyal
12393,4,1582.6000000000001,72,4,4,3,11,Loyal
12394,2,1272.48,64,2,4,3,9,Loyal
12395,12,3018.63,19,5,5,4,14,Champion
12397,2,2409.9,36,2,5,3,10,Loyal
12398,1,1635.6599999999999,46,1,4,3,8,SomeWhat Loyal
12399,4,1108.65,119,4,4,2,10,Loyal
12401,1,84.3,303,1,1,1,3,LOST
12402,1,225.6,323,1,1,1,3,LOST
12403,1,427.7,50,1,2,3,6,SomeWhat Loyal
12405,1,1710.39,149,1,4,2,7,SomeWhat Loyal
12406,2,3415.3,22,2,5,4,11,Loyal
12407,5,1708.1200000000001,50,4,4,3,11,Loyal
12408,5,2888.55,33,4,5,4,13,Champion
12409,3,11072.67,79,3,5,2,10,Loyal
12410,2,693.3299999999999,309,2,3,1,6,SomeWhat Loyal
12412,3,1226.88,75,3,4,2,9,Loyal
12413,3,758.1,67,3,3,3,9,Loyal
12414,3,562.41,217,3,3,1,7,SomeWhat Loyal
12415,21,124914.53,24,5,5,4,14,Champion
12417,9,3649.1,3,5,5,5,15,Champion
12418,1,668.58,113,1,3,2,6,SomeWhat Loyal
12420,1,600.39,64,1,3,3,7,SomeWhat Loyal
12421,4,807.04,16,4,3,4,11,Loyal
12422,3,803.5600000000001,96,3,3,2,8,SomeWhat Loyal
12423,8,1859.31,1,5,4,5,14,Champion
12424,2,1760.96,163,2,4,2,8,SomeWhat Loyal
12425,1,777.2,78,1,3,2,6,SomeWhat Loyal
12426,1,582.73,195,1,3,1,5,SomeWhat Loyal
12427,3,825.8,22,3,3,4,10,Loyal
12428,9,7956.46,26,5,5,4,14,Champion
12429,4,3750.4,9,4,5,5,14,Champion
12430,1,256.4,43,1,2,3,6,SomeWhat Loyal
12431,15,6487.45,36,5,5,3,13,Champion
12432,5,5059.32,43,4,5,3,12,Loyal
12433,7,13375.87,1,5,5,5,15,Champion
12434,2,806.14,85,2,3,2,7,SomeWhat Loyal
12435,2,7829.89,80,2,5,2,9,Loyal
12436,1,509.01,100,1,3,2,6,SomeWhat Loyal
12437,18,4951.41,2,5,5,5,15,Champion
12438,2,2906.85,14,2,5,4,11,Loyal
12441,1,173.55,367,1,1,1,3,LOST
12442,1,172.06,3,1,1,5,7,SomeWhat Loyal
12444,5,5005.46,21,4,5,4,13,Champion
12445,1,133.4,22,1,1,4,6,SomeWhat Loyal
12446,1,1002.3100000000001,58,1,4,3,8,SomeWhat Loyal
12447,1,476.49,243,1,2,1,4,Others
12448,1,449.45,44,1,2,3,6,SomeWhat Loyal
12449,4,4067.29,22,4,5,4,13,Champion
12450,2,197.88,156,2,1,2,5,SomeWhat Loyal
12451,5,9035.52,11,4,5,5,14,Champion
12452,2,430.57,17,2,2,4,8,SomeWhat Loyal
12453,1,707.09,134,1,3,2,6,SomeWhat Loyal
12454,1,3528.34,56,1,5,3,9,Loyal
12455,6,2466.86,73,4,5,2,11,Loyal
12456,3,3181.04,44,3,5,3,11,Loyal
12457,7,2363.23,66,5,5,3,13,Champion
12458,2,947.4,71,2,4,3,9,Loyal
12461,2,826.88,94,2,3,2,7,SomeWhat Loyal
12462,2,1189.59,19,2,4,4,10,Loyal
12463,4,1344.78,53,4,4,3,11,Loyal
12464,8,1212.05,10,5,4,5,14,Champion
12465,2,742.1899999999999,17,2,3,4,9,Loyal
12468,2,729.5400000000001,188,2,3,1,6,SomeWhat Loyal
12471,30,19824.05,2,5,5,5,15,Champion
12472,7,6572.11,32,5,5,4,14,Champion
12473,5,3938.5499999999997,29,4,5,4,13,Champion
12474,18,7375.79,17,5,5,4,14,Champion
12475,1,723.38,54,1,3,3,7,SomeWhat Loyal
12476,11,6816.42,16,5,5,4,14,Champion
12477,6,13219.74,23,4,5,4,13,Champion
12478,1,680.99,4,1,3,5,9,Loyal
12479,1,527.2,11,1,3,5,9,Loyal
12480,4,3281.63,28,4,5,4,13,Champion
12481,10,5596.32,23,5,5,4,14,Champion
12483,8,2484.98,17,5,5,4,14,Champion
12484,6,4541.72,33,4,5,4,13,Champion
12488,3,1298.66,10,3,4,5,12,Loyal
12489,1,334.93,336,1,2,1,4,Others
12490,10,5417.93,5,5,5,5,15,Champion
12491,1,460.40000000000003,39,1,2,3,6,SomeWhat Loyal
12492,2,263.21000000000004,63,2,2,3,7,SomeWhat Loyal
12493,2,433.74,166,2,2,2,6,SomeWhat Loyal
12494,7,1246.1000000000001,16,5,4,4,13,Champion
12497,1,1043.1,82,1,4,2,7,SomeWhat Loyal
12498,3,403.70000000000005,21,3,2,4,9,Loyal
12500,11,4257.82,23,5,5,4,14,Champion
12501,1,2169.39,337,1,5,1,7,SomeWhat Loyal
12502,5,3723.87,96,4,5,2,11,Loyal
12504,2,482.04999999999995,18,2,2,4,8,SomeWhat Loyal
12506,1,73.5,233,1,1,1,3,LOST
12507,3,1304.81,134,3,4,2,9,Loyal
12508,2,398.27,26,2,2,4,8,SomeWhat Loyal
12509,1,176.5,284,1,1,1,3,LOST
12510,2,982.5699999999999,143,2,4,2,8,SomeWhat Loyal
12512,2,138.03,66,2,1,3,6,SomeWhat Loyal
12513,1,612.29,113,1,3,2,6,SomeWhat Loyal
12514,1,1017.68,267,1,4,1,6,SomeWhat Loyal
12515,1,383.7,353,1,2,1,4,Others
12516,2,1312.06,78,2,4,2,8,SomeWhat Loyal
12517,5,2502.84,28,4,5,4,13,Champion
12518,5,2056.89,1,4,4,5,13,Champion
12519,1,340.84,64,1,2,3,6,SomeWhat Loyal
12520,5,2634.26,79,4,5,2,11,Loyal
12521,1,599.68,143,1,3,2,6,SomeWhat Loyal
12522,2,192.72,39,2,1,3,6,SomeWhat Loyal
12523,11,1789.77,19,5,4,4,13,Champion
12524,8,4485.72,9,5,5,5,15,Champion
12526,3,1316.66,1,3,4,5,12,Loyal
12527,3,348.71000000000004,82,3,2,2,7,SomeWhat Loyal
12528,6,1933.48,9,5,4,5,14,Champion
12530,4,1662.28,60,4,4,3,11,Loyal
12531,1,125.22,15,1,1,4,6,SomeWhat Loyal
12532,1,349.83000000000004,30,1,2,4,7,SomeWhat Loyal
12534,1,1089.18,131,1,4,2,7,SomeWhat Loyal
12535,2,716.35,92,2,3,2,7,SomeWhat Loyal
12536,3,12601.830000000002,43,3,5,3,11,Loyal
12538,1,363.95,29,1,2,4,7,SomeWhat Loyal
12539,4,5568.35,22,4,5,4,13,Champion
12540,17,13400.24,20,5,5,4,14,Champion
12541,3,981.18,30,3,4,4,11,Loyal
12544,1,372.7,36,1,2,3,6,SomeWhat Loyal
12545,2,1000.39,75,2,4,2,8,SomeWhat Loyal
12546,2,1161.5,47,2,4,3,9,Loyal
12547,2,207.79999999999998,198,2,1,1,4,Others
12548,1,95.19999999999999,166,1,1,2,4,Others
12550,1,964.83,79,1,4,2,7,SomeWhat Loyal
12551,1,168.0,358,1,1,1,3,LOST
12552,2,437.82,39,2,2,3,7,SomeWhat Loyal
12553,10,3692.28,8,5,5,5,15,Champion
12556,2,603.71,50,2,3,3,8,SomeWhat Loyal
12557,5,11990.960000000001,16,4,5,4,13,Champion
12558,1,269.96,8,1,2,5,8,SomeWhat Loyal
12559,2,561.71,311,2,3,1,6,SomeWhat Loyal
12560,3,2134.01,5,3,5,5,13,Champion
12561,1,238.85,303,1,1,1,3,LOST
12562,7,3781.7400000000002,8,5,5,5,15,Champion
12564,1,456.9,261,1,2,1,4,Others
12565,1,145.92,289,1,1,1,3,LOST
12566,1,351.65,86,1,2,2,5,SomeWhat Loyal
12567,10,9401.28,23,5,5,4,14,Champion
12569,32,4124.69,2,5,5,5,15,Champion
12571,2,519.61,40,2,3,3,8,SomeWhat Loyal
12572,2,1020.42,9,2,4,5,11,Loyal
12573,1,160.54000000000002,227,1,1,1,3,LOST
12574,1,218.45,316,1,1,1,3,LOST
12576,5,1315.83,36,4,4,3,11,Loyal
12577,3,657.8,35,3,3,3,9,Loyal
12578,2,2794.51,21,2,5,4,11,Loyal
12579,1,440.42,78,1,2,2,5,SomeWhat Loyal
12580,1,415.7,247,1,2,1,4,Others
12581,1,197.71,40,1,1,3,5,SomeWhat Loyal
12582,2,511.36,239,2,3,1,6,SomeWhat Loyal
12583,15,7281.38,3,5,5,5,15,Champion
12584,9,2338.15,4,5,5,5,15,Champion
12585,2,2040.1,234,2,4,1,7,SomeWhat Loyal
12586,1,196.94000000000003,17,1,1,4,6,SomeWhat Loyal
12587,1,144.0,8,1,1,5,7,SomeWhat Loyal
12588,1,214.89999999999998,39,1,1,3,5,SomeWhat Loyal
12589,2,646.68,29,2,3,4,9,Loyal
12590,2,9864.26,211,2,5,1,8,SomeWhat Loyal
12591,1,452.84999999999997,317,1,2,1,4,Others
12592,2,437.6,92,2,2,2,6,SomeWhat Loyal
12593,3,418.09999999999997,109,3,2,2,7,SomeWhat Loyal
12594,10,3338.2200000000003,38,5,5,3,13,Champion
12596,2,618.27,51,2,3,3,8,SomeWhat Loyal
12597,4,3811.22,19,4,5,4,13,Champion
12598,8,3023.08,10,5,5,5,15,Champion
12599,7,1032.58,29,5,4,4,13,Champion
12600,10,2599.04,29,5,5,4,14,Champion
12601,5,577.0600000000001,190,4,3,1,8,SomeWhat Loyal
12602,1,153.12,59,1,1,3,5,SomeWhat Loyal
12603,1,739.1999999999999,22,1,3,4,8,SomeWhat Loyal
12604,2,254.18,79,2,2,2,6,SomeWhat Loyal
12607,1,1579.51,60,1,4,3,8,SomeWhat Loyal
12609,3,1126.85,78,3,4,2,9,Loyal
12610,5,2099.54,23,4,5,4,13,Champion
12611,1,1193.32,52,1,4,3,8,SomeWhat Loyal
12612,1,704.0400000000001,74,1,3,2,6,SomeWhat Loyal
12613,5,3344.38,57,4,5,3,12,Loyal
12614,1,315.6,278,1,2,1,4,Others
12615,4,2291.19,2,4,5,5,14,Champion
12616,2,713.3,95,2,3,2,7,SomeWhat Loyal
12617,1,355.53,29,1,2,4,7,SomeWhat Loyal
12618,1,177.31,22,1,1,4,6,SomeWhat Loyal
12619,9,3641.24,16,5,5,4,14,Champion
12620,3,1339.41,15,3,4,4,11,Loyal
12621,20,13689.67,2,5,5,5,15,Champion
12622,1,180.1,232,1,1,1,3,LOST
12623,1,305.1,276,1,2,1,4,Others
12624,2,641.13,106,2,3,2,7,SomeWhat Loyal
12625,2,2683.82,212,2,5,1,8,SomeWhat Loyal
12626,9,6620.48,23,5,5,4,14,Champion
12627,7,4478.53,11,5,5,5,15,Champion
12628,3,786.46,4,3,3,5,11,Loyal
12630,2,1270.88,10,2,4,5,11,Loyal
12631,1,640.5,57,1,3,3,7,SomeWhat Loyal
12633,4,2163.98,59,4,5,3,12,Loyal
12635,2,1689.18,90,2,4,2,8,SomeWhat Loyal
12637,8,6021.9,67,5,5,3,13,Champion
12638,1,671.69,33,1,3,4,8,SomeWhat Loyal
12639,1,486.1,239,1,2,1,4,Others
12640,3,1174.58,24,3,4,4,11,Loyal
12641,1,185.9,115,1,1,2,4,Others
12642,3,1013.26,25,3,4,4,11,Loyal
12643,6,3344.64,128,5,5,2,12,Loyal
12644,1,477.91,130,1,2,2,5,SomeWhat Loyal
12645,4,1775.18,34,4,4,3,11,Loyal
12646,2,1346.97,5,2,4,5,11,Loyal
12647,12,3722.82,22,5,5,4,14,Champion
12648,1,318.05,155,1,2,2,5,SomeWhat Loyal
12649,3,623.51,107,3,3,2,8,SomeWhat Loyal
12650,1,314.44,3,1,2,5,8,SomeWhat Loyal
12651,1,114.0,335,1,1,1,3,LOST
12652,1,919.98,331,1,3,1,5,SomeWhat Loyal
12653,2,2209.85,149,2,5,2,9,Loyal
12654,5,601.98,11,4,3,5,12,Loyal
12656,5,4051.17,17,4,5,4,13,Champion
12657,4,1643.18,11,4,4,5,13,Champion
12658,1,686.05,19,1,3,4,8,SomeWhat Loyal
12659,1,91.68,30,1,1,4,6,SomeWhat Loyal
12660,1,245.1,11,1,1,5,7,SomeWhat Loyal
12662,11,3849.78,1,5,5,5,15,Champion
12664,9,4881.88,8,5,5,5,15,Champion
12665,1,63.0,325,1,1,1,3,LOST
12667,1,620.13,58,1,3,3,7,SomeWhat Loyal
12668,4,3807.15,12,4,5,5,14,Champion
12669,3,2744.0299999999997,151,3,5,2,10,Loyal
12670,5,2996.05,10,4,5,5,14,Champion
12672,1,225.89999999999998,330,1,1,1,3,LOST
12673,2,610.52,5,2,3,5,10,Loyal
12674,4,1970.6,39,4,4,3,11,Loyal
12676,6,1331.39,25,5,4,4,13,Champion
12678,12,17628.46,42,5,5,3,13,Champion
12679,4,1113.02,59,4,4,3,11,Loyal
12680,4,862.81,1,4,3,5,12,Loyal
12681,22,13787.54,15,5,5,4,14,Champion
12682,31,12288.22,4,5,5,5,15,Champion
12683,15,8476.57,4,5,5,5,15,Champion
12684,7,2283.63,8,5,5,5,15,Champion
12685,6,2863.08,28,5,5,4,14,Champion
12686,1,89.14,372,1,1,1,3,LOST
12688,1,4873.8099999999995,114,1,5,2,8,SomeWhat Loyal
12689,2,1247.61,26,2,4,4,10,Loyal
12690,1,389.01,206,1,2,1,4,Others
12691,6,1035.8,28,5,4,4,13,Champion
12693,4,855.91,127,4,3,2,9,Loyal
12694,2,869.67,70,2,3,3,8,SomeWhat Loyal
12695,4,582.1,7,4,3,5,12,Loyal
12697,3,957.59,29,3,4,4,11,Loyal
12700,4,4939.99,8,4,5,5,14,Champion
12701,2,797.71,80,2,3,2,7,SomeWhat Loyal
12702,1,219.0,20,1,1,4,6,SomeWhat Loyal
12703,1,283.55,71,1,2,3,6,SomeWhat Loyal
12704,8,2340.84,7,5,5,5,15,Champion
12705,9,6868.29,15,5,5,4,14,Champion
12707,1,603.42,292,1,3,1,5,SomeWhat Loyal
12708,10,2712.91,30,5,5,4,14,Champion
12709,15,9736.52,15,5,5,4,14,Champion
12710,3,1149.02,97,3,4,2,9,Loyal
12712,13,4396.13,29,5,5,4,14,Champion
12713,1,848.55,1,1,3,5,9,Loyal
12714,5,4708.86,9,4,5,5,14,Champion
12715,1,353.86,106,1,2,2,5,SomeWhat Loyal
12716,2,1053.49,4,2,4,5,11,Loyal
12717,2,1030.98,151,2,4,2,8,SomeWhat Loyal
12718,1,238.25,71,1,1,3,5,SomeWhat Loyal
12719,2,644.95,5,2,3,5,10,Loyal
12720,25,5781.73,3,5,5,5,15,Champion
12721,6,2656.13,32,5,5,4,14,Champion
12722,4,997.63,85,4,4,2,10,Loyal
12723,5,725.07,4,4,3,5,12,Loyal
12724,4,1031.41,5,4,4,5,13,Champion
12725,1,427.8,371,1,2,1,4,Others
12726,7,2609.1,28,5,5,4,14,Champion
12727,7,3980.7,11,5,5,5,15,Champion
12728,4,836.33,71,4,3,3,10,Loyal
12729,1,453.01,114,1,2,2,5,SomeWhat Loyal
12731,12,18895.91,24,5,5,4,14,Champion
12732,1,236.26000000000002,180,1,1,1,3,LOST
12733,1,383.95,234,1,2,1,4,Others
12734,1,110.39999999999999,353,1,1,1,3,LOST
12735,2,779.5699999999999,315,2,3,1,6,SomeWhat Loyal
12736,1,234.0,333,1,1,1,3,LOST
12738,1,155.35,372,1,1,1,3,LOST
12739,2,1013.04,78,2,4,2,8,SomeWhat Loyal
12740,1,427.6,64,1,2,3,6,SomeWhat Loyal
12743,2,546.43,134,2,3,2,7,SomeWhat Loyal
12744,7,21279.29,52,5,5,3,13,Champion
12747,11,4196.01,2,5,5,5,15,Champion
12748,209,33719.73,1,5,5,5,15,Champion
12749,5,4090.88,4,4,5,5,14,Champion
12750,1,275.88,129,1,2,2,5,SomeWhat Loyal
12752,1,4366.78,81,1,5,2,8,SomeWhat Loyal
12753,6,21429.39,23,5,5,4,14,Champion
12754,3,3010.74,236,3,5,1,9,Loyal
12755,2,3811.95,281,2,5,1,8,SomeWhat Loyal
12756,1,112.07999999999998,87,1,1,2,4,Others
12757,13,7857.1,16,5,5,4,14,Champion
12758,2,2791.59,117,2,5,2,9,Loyal
12759,3,1531.44,52,3,4,3,10,Loyal
12762,2,1898.52,8,2,4,5,11,Loyal
12763,2,494.08,138,2,3,2,7,SomeWhat Loyal
12764,1,1693.88,317,1,4,1,6,SomeWhat Loyal
12766,7,6989.63,4,5,5,5,15,Champion
12769,1,1143.6,239,1,4,1,6,SomeWhat Loyal
12770,1,1351.45,211,1,4,1,6,SomeWhat Loyal
12772,1,892.47,60,1,3,3,7,SomeWhat Loyal
12775,5,1386.04,17,4,4,4,12,Loyal
12778,6,822.23,20,5,3,4,12,Loyal
12779,8,3981.36,38,5,5,3,13,Champion
12781,2,826.74,64,2,3,3,8,SomeWhat Loyal
12782,5,2330.92,5,4,5,5,14,Champion
12783,6,2225.91,2,5,5,5,15,Champion
12784,2,574.42,9,2,3,5,10,Loyal
12785,1,311.95,364,1,2,1,4,Others
12787,3,463.66,10,3,2,5,10,Loyal
12789,1,91.85,65,1,1,3,5,SomeWhat Loyal
12790,1,324.92,192,1,2,1,4,Others
12791,1,192.60000000000002,374,1,1,1,3,LOST
12792,1,400.53999999999996,257,1,2,1,4,Others
12793,2,545.48,335,2,3,1,6,SomeWhat Loyal
12794,2,860.41,53,2,3,3,8,SomeWhat Loyal
12795,1,430.48,19,1,2,4,7,SomeWhat Loyal
12797,1,254.03,366,1,2,1,4,Others
12798,3,6977.04,10,3,5,5,13,Champion
12802,1,427.58,187,1,2,1,4,Others
12808,3,483.65000000000003,37,3,2,3,8,SomeWhat Loyal
12809,1,489.31,178,1,2,2,5,SomeWhat Loyal
12811,3,514.85,261,3,3,1,7,SomeWhat Loyal
12812,1,229.64000000000001,45,1,1,3,5,SomeWhat Loyal
12814,1,125.92,102,1,1,2,4,Others
12815,2,1063.46,148,2,4,2,8,SomeWhat Loyal
12816,2,572.2,96,2,3,2,7,SomeWhat Loyal
12817,1,166.04,281,1,1,1,3,LOST
12818,1,1542.08,262,1,4,1,6,SomeWhat Loyal
12820,4,942.34,3,4,4,5,13,Champion
12821,1,92.72,214,1,1,1,3,LOST
12822,2,948.88,71,2,4,3,9,Loyal
12823,5,1759.5,75,4,4,2,10,Loyal
12824,1,397.12,60,1,2,3,6,SomeWhat Loyal
12826,7,1474.72,3,5,4,5,14,Champion
12827,3,430.15000000000003,6,3,2,5,10,Loyal
12828,6,1018.71,3,5,4,5,14,Champion
12829,2,293.0,337,2,2,1,5,SomeWhat Loyal
12830,6,6814.64,38,5,5,3,13,Champion
12831,1,215.05,262,1,1,1,3,LOST
12832,2,383.03,32,2,2,4,8,SomeWhat Loyal
12833,1,417.38,145,1,2,2,5,SomeWhat Loyal
12834,1,312.38,283,1,2,1,4,Others
12836,4,2612.86,59,4,5,3,12,Loyal
12837,1,134.1,173,1,1,2,4,Others
12838,2,683.13,34,2,3,3,8,SomeWhat Loyal
12839,14,5591.42,3,5,5,5,15,Champion
12840,4,2726.77,144,4,5,2,11,Loyal
12841,25,4022.35,5,5,5,5,15,Champion
12842,2,1118.99,70,2,4,3,9,Loyal
12843,8,1702.26,66,5,4,3,12,Loyal
12844,2,325.96000000000004,29,2,2,4,8,SomeWhat Loyal
12845,4,354.09,267,4,2,1,7,SomeWhat Loyal
12847,1,871.54,22,1,3,4,8,SomeWhat Loyal
12849,2,1050.8899999999999,31,2,4,4,10,Loyal
12851,1,135.18,97,1,1,2,4,Others
12852,1,311.55,295,1,2,1,4,Others
12853,6,1957.1000000000001,135,5,4,2,11,Loyal
12854,3,1324.5,79,3,4,2,9,Loyal
12855,1,38.1,373,1,1,1,3,LOST
12856,6,2179.93,8,5,5,5,15,Champion
12857,2,1106.4,211,2,4,1,7,SomeWhat Loyal
12863,1,521.2,52,1,3,3,7,SomeWhat Loyal
12864,1,147.12,138,1,1,2,4,Others
12865,2,1568.23,26,2,4,4,10,Loyal
12866,1,559.12,283,1,3,1,5,SomeWhat Loyal
12867,7,4036.82,26,5,5,4,14,Champion
12868,6,1607.0600000000002,186,5,4,1,10,Loyal
12871,2,380.64,84,2,2,2,6,SomeWhat Loyal
12872,2,599.97,327,2,3,1,6,SomeWhat Loyal
12873,1,374.0,282,1,2,1,4,Others
12875,2,343.2300000000001,143,2,2,2,6,SomeWhat Loyal
12876,2,2218.02,58,2,5,3,10,Loyal
12877,12,1535.77,4,5,4,5,14,Champion
12878,2,854.99,236,2,3,1,6,SomeWhat Loyal
12879,3,573.22,45,3,3,3,9,Loyal
12881,1,298.0,276,1,2,1,4,Others
12882,2,1463.04,9,2,4,5,11,Loyal
12883,4,703.47,25,4,3,4,11,Loyal
12884,1,309.05,88,1,2,2,5,SomeWhat Loyal
12885,3,1175.22,63,3,4,3,10,Loyal
12886,2,1378.4,68,2,4,3,9,Loyal
12888,2,354.12,214,2,2,1,5,SomeWhat Loyal
12890,1,380.46999999999997,24,1,2,4,7,SomeWhat Loyal
12891,3,331.0,186,3,2,1,6,SomeWhat Loyal
12893,1,188.14,31,1,1,4,6,SomeWhat Loyal
12895,2,372.8,42,2,2,3,7,SomeWhat Loyal
12897,2,216.5,205,2,1,1,4,Others
12901,28,17654.54,9,5,5,5,15,Champion
12902,1,138.68,265,1,1,1,3,LOST
12904,2,509.58,18,2,3,4,9,Loyal
12906,5,2919.81,12,4,5,5,14,Champion
12908,2,750.0,176,2,3,2,7,SomeWhat Loyal
12909,5,2178.67,40,4,5,3,12,Loyal
12910,8,3075.04,23,5,5,4,14,Champion
12912,5,1662.3,3,4,4,5,13,Champion
12913,5,2483.63,5,4,5,5,14,Champion
12915,2,363.65,149,2,2,2,6,SomeWhat Loyal
12916,4,3006.15,139,4,5,2,11,Loyal
12917,1,594.0,128,1,3,2,6,SomeWhat Loyal
12919,6,1335.19,8,5,4,5,14,Champion
12920,1,164.23,17,1,1,4,6,SomeWhat Loyal
12921,37,16587.09,9,5,5,5,15,Champion
12922,1,405.38,161,1,2,2,5,SomeWhat Loyal
12923,1,176.97,64,1,1,3,5,SomeWhat Loyal
12924,4,933.7,88,4,3,2,9,Loyal
12925,2,694.05,5,2,3,5,10,Loyal
12928,5,2062.7000000000003,35,4,5,3,12,Loyal
12929,1,117.85,312,1,1,1,3,LOST
12930,2,415.8,78,2,2,2,6,SomeWhat Loyal
12931,15,42055.96,22,5,5,4,14,Champion
12933,3,607.53,24,3,3,4,10,Loyal
12935,7,2160.7,2,5,5,5,15,Champion
12936,4,1063.9,17,4,4,4,12,Loyal
12937,4,1504.27,15,4,4,4,12,Loyal
12938,1,114.14,26,1,1,4,6,SomeWhat Loyal
12939,8,11581.8,64,5,5,3,13,Champion
12940,2,913.54,55,2,3,3,8,SomeWhat Loyal
12942,3,683.9,131,3,3,2,8,SomeWhat Loyal
12944,2,604.51,36,2,3,3,8,SomeWhat Loyal
12945,1,462.95,288,1,2,1,4,Others
12947,6,1603.99,144,5,4,2,11,Loyal
12948,7,2064.95,16,5,5,4,14,Champion
12949,8,4167.22,31,5,5,4,14,Champion
12950,3,1843.0,2,3,4,5,12,Loyal
12951,6,1064.07,9,5,4,5,14,Champion
12952,4,1387.79,6,4,4,5,13,Champion
12953,1,329.85,10,1,2,5,8,SomeWhat Loyal
12955,11,4757.16,1,5,5,5,15,Champion
12956,1,108.07,306,1,1,1,3,LOST
12957,8,4017.54,10,5,5,5,15,Champion
12962,2,266.39,7,2,2,5,9,Loyal
12963,8,1856.63,8,5,4,5,14,Champion
12965,1,771.91,89,1,3,2,6,SomeWhat Loyal
12966,1,160.18,10,1,1,5,7,SomeWhat Loyal
12967,2,1660.9,358,2,4,1,7,SomeWhat Loyal
12968,1,135.95,112,1,1,2,4,Others
12970,4,452.24,7,4,2,5,11,Loyal
12971,86,11189.91,4,5,5,5,15,Champion
12974,1,144.8,198,1,1,1,3,LOST
12976,1,738.6,212,1,3,1,5,SomeWhat Loyal
12977,1,39.239999999999995,156,1,1,2,4,Others
12980,9,7374.900000000001,158,5,5,2,12,Loyal
12981,2,372.21999999999997,30,2,2,4,8,SomeWhat Loyal
12982,1,390.54,243,1,2,1,4,Others
12984,1,97.5,19,1,1,4,6,SomeWhat Loyal
12985,2,1239.38,1,2,4,5,11,Loyal
12987,2,558.7,74,2,3,2,7,SomeWhat Loyal
12988,1,535.32,292,1,3,1,5,SomeWhat Loyal
12989,15,6924.110000000001,3,5,5,5,15,Champion
12990,3,409.5,31,3,2,4,9,Loyal
12991,2,503.76,23,2,3,4,9,Loyal
12993,4,414.76,23,4,2,4,10,Loyal
12994,3,974.4200000000001,4,3,4,5,12,Loyal
12995,1,211.32,85,1,1,2,4,Others
12997,4,1226.89,22,4,4,4,12,Loyal
12999,3,455.88,196,3,2,1,6,SomeWhat Loyal
13000,3,534.85,107,3,3,2,8,SomeWhat Loyal
13001,13,9818.82,4,5,5,5,15,Champion
13002,1,120.94999999999999,318,1,1,1,3,LOST
13003,3,149.05,106,3,1,2,6,SomeWhat Loyal
13004,18,5655.91,12,5,5,5,15,Champion
13005,2,513.7,174,2,3,2,7,SomeWhat Loyal
13006,1,81.57,56,1,1,3,5,SomeWhat Loyal
13008,1,229.46999999999997,323,1,1,1,3,LOST
13011,1,50.550000000000004,372,1,1,1,3,LOST
13012,8,1661.8400000000001,9,5,4,5,14,Champion
13013,13,4810.9400000000005,1,5,5,5,15,Champion
13014,10,3466.2799999999997,11,5,5,5,15,Champion
13015,5,3346.28,53,4,5,3,12,Loyal
13016,3,789.89,73,3,3,2,8,SomeWhat Loyal
13017,1,204.0,7,1,1,5,7,SomeWhat Loyal
13018,28,7277.7,16,5,5,4,14,Champion
13021,9,2616.38,4,5,5,5,15,Champion
13023,2,689.9,64,2,3,3,8,SomeWhat Loyal
13026,5,975.36,1,4,4,5,13,Champion
13027,6,6912.0,114,5,5,2,12,Loyal
13028,2,661.3199999999999,23,2,3,4,9,Loyal
13029,3,1247.5,31,3,4,4,11,Loyal
13030,2,799.48,11,2,3,5,10,Loyal
13032,2,1010.18,52,2,4,3,9,Loyal
13033,1,190.55,357,1,1,1,3,LOST
13034,2,642.77,55,2,3,3,8,SomeWhat Loyal
13035,2,921.88,74,2,3,2,7,SomeWhat Loyal
13037,3,881.07,138,3,3,2,8,SomeWhat Loyal
13038,3,908.46,80,3,3,2,8,SomeWhat Loyal
13040,2,676.99,9,2,3,5,10,Loyal
13043,1,516.42,273,1,3,1,5,SomeWhat Loyal
13044,1,560.47,291,1,3,1,5,SomeWhat Loyal
13045,1,305.28000000000003,99,1,2,2,5,SomeWhat Loyal
13046,2,629.31,31,2,3,4,9,Loyal
13047,10,3237.54,32,5,5,4,14,Champion
13048,4,1835.91,14,4,4,4,12,Loyal
13049,2,656.6800000000001,64,2,3,3,8,SomeWhat Loyal
13050,17,5836.86,15,5,5,4,14,Champion
13052,1,348.15000000000003,212,1,2,1,4,Others
13055,3,1214.41,78,3,4,2,9,Loyal
13058,3,271.40000000000003,25,3,2,4,9,Loyal
13059,1,183.4,250,1,1,1,3,LOST
13060,1,307.53,254,1,2,1,4,Others
13061,1,248.61,72,1,1,3,5,SomeWhat Loyal
13062,1,346.98,191,1,2,1,4,Others
13064,4,1119.49,13,4,4,5,13,Champion
13065,1,205.86,373,1,1,1,3,LOST
13066,2,470.8,24,2,2,4,8,SomeWhat Loyal
13067,1,115.46000000000001,82,1,1,2,4,Others
13068,2,344.0,10,2,2,5,9,Loyal
13069,24,4436.12,1,5,5,5,15,Champion
13070,1,228.8,192,1,1,1,3,LOST
13072,1,177.15,267,1,1,1,3,LOST
13075,1,919.61,130,1,3,2,6,SomeWhat Loyal
13077,4,729.27,1,4,3,5,12,Loyal
13078,26,12627.94,3,5,5,5,15,Champion
13079,5,220.10000000000002,4,4,1,5,10,Loyal
13080,1,58.08,179,1,1,2,4,Others
13081,11,28337.38,12,5,5,5,15,Champion
13082,9,3613.63,126,5,5,2,12,Loyal
13083,2,303.75,4,2,2,5,9,Loyal
13085,2,416.08000000000004,158,2,2,2,6,SomeWhat Loyal
13089,97,58825.83,3,5,5,5,15,Champion
13090,14,8910.82,9,5,5,5,15,Champion
13091,1,345.82,28,1,2,4,7,SomeWhat Loyal
13092,5,477.83,71,4,2,3,9,Loyal
13093,8,7832.47,276,5,5,1,11,Loyal
13094,12,1927.3200000000002,21,5,4,4,13,Champion
13095,1,74.39999999999999,71,1,1,3,5,SomeWhat Loyal
13097,10,6010.42,33,5,5,4,14,Champion
13098,28,28882.44,1,5,5,5,15,Champion
13099,1,207.35999999999999,99,1,1,2,4,Others
13101,1,101.19,234,1,1,1,3,LOST
13102,24,6424.09,1,5,5,5,15,Champion
13103,1,243.94,40,1,1,3,5,SomeWhat Loyal
13104,6,1098.48,3,5,4,5,14,Champion
13106,1,76.5,133,1,1,2,4,Others
13107,4,1531.6200000000001,44,4,4,3,11,Loyal
13108,1,350.06,373,1,2,1,4,Others
13109,2,786.54,60,2,3,3,8,SomeWhat Loyal
13110,7,1488.67,31,5,4,4,13,Champion
13113,24,12245.960000000001,1,5,5,5,15,Champion
13115,4,2294.78,12,4,5,5,14,Champion
13116,1,501.14,138,1,3,2,6,SomeWhat Loyal
13117,8,984.91,22,5,4,4,13,Champion
13118,5,1197.81,20,4,4,4,12,Loyal
13120,1,30.599999999999998,239,1,1,1,3,LOST
13121,1,283.73,269,1,2,1,4,Others
13122,2,922.39,94,2,3,2,7,SomeWhat Loyal
13124,3,3866.33,90,3,5,2,10,Loyal
13126,8,2099.64,5,5,5,5,15,Champion
13127,1,259.17,78,1,2,2,5,SomeWhat Loyal
13130,1,64.0,94,1,1,2,4,Others
13131,3,1073.3,23,3,4,4,11,Loyal
13132,1,77.3,262,1,1,1,3,LOST
13133,2,109.8,274,2,1,1,4,Others
13134,4,1793.58,86,4,4,2,10,Loyal
13135,1,3096.0,197,1,5,1,7,SomeWhat Loyal
13136,5,2607.61,56,4,5,3,12,Loyal
13137,8,3650.41,11,5,5,5,15,Champion
13138,6,962.39,22,5,4,4,13,Champion
13139,7,5064.94,16,5,5,4,14,Champion
13140,3,423.72,108,3,2,2,7,SomeWhat Loyal
13141,5,2388.75,85,4,5,2,11,Loyal
13142,1,307.09,19,1,2,4,7,SomeWhat Loyal
13144,1,110.95,333,1,1,1,3,LOST
13145,4,618.52,40,4,3,3,10,Loyal
13146,1,228.91,26,1,1,4,6,SomeWhat Loyal
13147,4,712.8000000000001,10,4,3,5,12,Loyal
13148,12,3707.12,29,5,5,4,14,Champion
13149,4,1676.06,14,4,4,4,12,Loyal
13151,1,1257.8700000000001,296,1,4,1,6,SomeWhat Loyal
13153,1,486.22,6,1,2,5,8,SomeWhat Loyal
13155,4,971.76,33,4,4,3,11,Loyal
13157,4,1741.22,49,4,4,3,11,Loyal
13158,4,1201.06,95,4,4,2,10,Loyal
13159,4,1437.85,9,4,4,5,13,Champion
13160,1,91.8,22,1,1,4,6,SomeWhat Loyal
13161,1,112.75,313,1,1,1,3,LOST
13162,4,1688.29,122,4,4,2,10,Loyal
13165,2,1021.48,46,2,4,3,9,Loyal
13166,1,417.2,283,1,2,1,4,Others
13167,4,791.33,19,4,3,4,11,Loyal
13168,4,1319.19,36,4,4,3,11,Loyal
13169,2,712.88,64,2,3,3,8,SomeWhat Loyal
13170,1,116.00999999999999,27,1,1,4,6,SomeWhat Loyal
13171,3,468.41,22,3,2,4,9,Loyal
13173,2,353.65,4,2,2,5,9,Loyal
13174,3,2817.03,16,3,5,4,12,Loyal
13176,1,492.84,46,1,3,3,7,SomeWhat Loyal
13177,1,282.45,65,1,2,3,6,SomeWhat Loyal
13178,11,5725.47,26,5,5,4,14,Champion
13182,1,121.18,45,1,1,3,5,SomeWhat Loyal
13183,9,3957.78,8,5,5,5,15,Champion
13184,10,1701.29,15,5,4,4,13,Champion
13185,1,71.4,268,1,1,1,3,LOST
13186,3,1575.89,40,3,4,3,10,Loyal
13187,1,236.02,337,1,1,1,3,LOST
13188,1,114.60000000000001,11,1,1,5,7,SomeWhat Loyal
13189,2,260.68,19,2,2,4,8,SomeWhat Loyal
13192,2,911.94,95,2,3,2,7,SomeWhat Loyal
13193,1,117.88,61,1,1,3,5,SomeWhat Loyal
13194,1,60.7,136,1,1,2,4,Others
13196,4,1797.78,11,4,4,5,13,Champion
13198,6,3401.2400000000002,10,5,5,5,15,Champion
13199,38,9817.12,4,5,5,5,15,Champion
13200,4,870.09,19,4,3,4,11,Loyal
13203,4,869.46,10,4,3,5,12,Loyal
13207,2,250.26000000000002,15,2,2,4,8,SomeWhat Loyal
13208,6,1223.9,59,5,4,3,12,Loyal
13209,8,5891.61,30,5,5,4,14,Champion
13210,1,353.48,94,1,2,2,5,SomeWhat Loyal
13211,3,1197.42,10,3,4,5,12,Loyal
13212,3,788.08,20,3,3,4,10,Loyal
13213,5,1520.58,57,4,4,3,11,Loyal
13216,1,333.74,268,1,2,1,4,Others
13217,3,533.98,122,3,3,2,8,SomeWhat Loyal
13218,1,62.63999999999999,127,1,1,2,4,Others
13220,4,819.2900000000001,78,4,3,2,9,Loyal
13221,2,847.41,240,2,3,1,6,SomeWhat Loyal
13223,2,163.20000000000002,200,2,1,1,4,Others
13224,2,2155.95,60,2,5,3,10,Loyal
13225,7,6463.84,3,5,5,5,15,Champion
13226,1,108.21000000000001,273,1,1,1,3,LOST
13227,1,257.7,202,1,2,1,4,Others
13228,1,358.0,81,1,2,2,5,SomeWhat Loyal
13229,1,160.95,226,1,1,1,3,LOST
13230,14,2806.97,4,5,5,5,15,Champion
13232,7,1357.6,13,5,4,5,14,Champion
13233,2,605.12,74,2,3,2,7,SomeWhat Loyal
13235,1,1031.07,212,1,4,1,6,SomeWhat Loyal
13236,2,744.85,25,2,3,4,9,Loyal
13238,4,700.73,17,4,3,4,11,Loyal
13239,1,329.56,262,1,2,1,4,Others
13240,4,663.65,96,4,3,2,9,Loyal
13242,3,270.40000000000003,112,3,2,2,7,SomeWhat Loyal
13243,1,600.07,203,1,3,1,5,SomeWhat Loyal
13244,1,121.74000000000001,93,1,1,2,4,Others
13245,1,430.5,51,1,2,3,6,SomeWhat Loyal
13246,6,1987.3,18,5,4,4,13,Champion
13247,4,501.12,18,4,3,4,11,Loyal
13248,2,465.68,125,2,2,2,6,SomeWhat Loyal
13249,3,711.41,92,3,3,2,8,SomeWhat Loyal
13253,2,1030.4,157,2,4,2,8,SomeWhat Loyal
13255,2,399.51,9,2,2,5,9,Loyal
13258,3,698.58,12,3,3,5,11,Loyal
13259,1,292.32,62,1,2,3,6,SomeWhat Loyal
13260,1,557.62,61,1,3,3,7,SomeWhat Loyal
13261,2,944.1,269,2,4,1,7,SomeWhat Loyal
13262,1,200.29,263,1,1,1,3,LOST
13263,35,7454.07,1,5,5,5,15,Champion
13265,5,2107.66,53,4,5,3,12,Loyal
13266,12,3834.2599999999998,11,5,5,5,15,Champion
13267,19,4521.49,3,5,5,5,15,Champion
13268,11,3214.69,18,5,5,4,14,Champion
13269,15,5346.2300000000005,1,5,5,5,15,Champion
13270,1,590.0,366,1,3,1,5,SomeWhat Loyal
13271,1,217.38,37,1,1,3,5,SomeWhat Loyal
13272,2,276.56,31,2,2,4,8,SomeWhat Loyal
13273,1,138.98,113,1,1,2,4,Others
13276,2,590.9300000000001,64,2,3,3,8,SomeWhat Loyal
13277,4,258.4,16,4,2,4,10,Loyal
13278,1,542.73,41,1,3,3,7,SomeWhat Loyal
13279,1,137.75,78,1,1,2,4,Others
13280,3,814.86,122,3,3,2,8,SomeWhat Loyal
13282,3,1132.14,18,3,4,4,11,Loyal
13283,2,93.66,60,2,1,3,6,SomeWhat Loyal
13284,1,201.19,331,1,1,1,3,LOST
13285,4,2709.12,23,4,5,4,13,Champion
13291,1,361.11,156,1,2,2,5,SomeWhat Loyal
13292,2,578.9399999999999,39,2,3,3,8,SomeWhat Loyal
13294,2,873.74,190,2,3,1,6,SomeWhat Loyal
13295,1,201.20000000000002,360,1,1,1,3,LOST
13296,1,87.4,137,1,1,2,4,Others
13297,4,2089.85,8,4,5,5,14,Champion
13298,1,360.0,1,1,2,5,8,SomeWhat Loyal
13299,1,142.5,268,1,1,1,3,LOST
13300,1,371.89,169,1,2,2,5,SomeWhat Loyal
13301,4,618.09,104,4,3,2,9,Loyal
13302,1,63.75,155,1,1,2,4,Others
13304,1,300.42,351,1,2,1,4,Others
13305,10,2000.86,4,5,4,5,14,Champion
13307,1,15.0,120,1,1,2,4,Others
13308,3,1385.51,23,3,4,4,11,Loyal
13309,5,1456.79,7,4,4,5,13,Champion
13310,3,1132.03,28,3,4,4,11,Loyal
13311,2,598.57,4,2,3,5,10,Loyal
13313,5,1555.32,22,4,4,4,12,Loyal
13314,3,775.94,2,3,3,5,11,Loyal
13316,4,5977.7300000000005,37,4,5,3,12,Loyal
13317,6,2273.68,66,5,5,3,13,Champion
13318,3,640.76,1,3,3,5,11,Loyal
13319,26,10845.550000000001,5,5,5,5,15,Champion
13320,4,1548.7,78,4,4,2,10,Loyal
13321,2,567.36,72,2,3,2,7,SomeWhat Loyal
13322,1,199.48000000000002,17,1,1,4,6,SomeWhat Loyal
13323,5,787.85,3,4,3,5,12,Loyal
13324,10,7121.95,36,5,5,3,13,Champion
13325,1,675.3,82,1,3,2,6,SomeWhat Loyal
13327,8,3627.77,39,5,5,3,13,Champion
13328,1,1308.48,316,1,4,1,6,SomeWhat Loyal
13329,2,789.0,32,2,3,4,9,Loyal
13330,3,1140.93,93,3,4,2,9,Loyal
13332,1,350.9,14,1,2,4,7,SomeWhat Loyal
13334,3,3536.82,82,3,5,2,10,Loyal
13336,1,795.12,77,1,3,2,6,SomeWhat Loyal
13338,1,487.02,158,1,2,2,5,SomeWhat Loyal
13339,1,860.12,201,1,3,1,5,SomeWhat Loyal
13340,7,10736.48,45,5,5,3,13,Champion
13341,1,775.85,261,1,3,1,5,SomeWhat Loyal
13343,1,353.43,178,1,2,2,5,SomeWhat Loyal
13344,3,2543.72,68,3,5,3,11,Loyal
13345,1,389.5,288,1,2,1,4,Others
13347,1,341.36,70,1,2,3,6,SomeWhat Loyal
13348,1,233.76,64,1,1,3,5,SomeWhat Loyal
13349,1,247.32,11,1,1,5,7,SomeWhat Loyal
13350,2,979.12,16,2,4,4,10,Loyal
13351,1,373.94,66,1,2,3,6,SomeWhat Loyal
13352,1,397.97999999999996,60,1,2,3,6,SomeWhat Loyal
13354,1,743.53,71,1,3,3,7,SomeWhat Loyal
13355,1,674.7,122,1,3,2,6,SomeWhat Loyal
13356,1,768.24,80,1,3,2,6,SomeWhat Loyal
13357,1,609.95,257,1,3,1,5,SomeWhat Loyal
13358,1,439.03,269,1,2,1,4,Others
13359,1,439.56,64,1,2,3,6,SomeWhat Loyal
13362,4,3090.7400000000002,9,4,5,5,14,Champion
13363,2,992.5,18,2,4,4,10,Loyal
13364,1,134.95999999999998,71,1,1,3,5,SomeWhat Loyal
13365,2,2225.37,34,2,5,3,10,Loyal
13366,1,56.160000000000004,50,1,1,3,5,SomeWhat Loyal
13368,2,623.4,257,2,3,1,6,SomeWhat Loyal
13369,1,308.28000000000003,366,1,2,1,4,Others
13370,1,754.87,372,1,3,1,5,SomeWhat Loyal
13372,1,378.64,90,1,2,2,5,SomeWhat Loyal
13373,3,3312.25,61,3,5,3,11,Loyal
13375,1,778.65,89,1,3,2,6,SomeWhat Loyal
13376,3,1019.76,99,3,4,2,9,Loyal
13379,3,572.56,26,3,3,4,10,Loyal
13381,6,3639.31,32,5,5,4,14,Champion
13382,1,222.99,281,1,1,1,3,LOST
13384,7,4151.93,31,5,5,4,14,Champion
13385,1,534.57,330,1,3,1,5,SomeWhat Loyal
13388,2,677.1,131,2,3,2,7,SomeWhat Loyal
13389,3,797.96,11,3,3,5,11,Loyal
13390,1,544.08,75,1,3,2,6,SomeWhat Loyal
13391,1,59.8,204,1,1,1,3,LOST
13394,8,2520.02,2,5,5,5,15,Champion
13395,1,307.72,185,1,2,1,4,Others
13396,2,1360.99,29,2,4,4,10,Loyal
13397,5,1544.13,73,4,4,2,10,Loyal
13398,1,457.34,192,1,2,1,4,Others
13402,2,621.23,127,2,3,2,7,SomeWhat Loyal
13403,1,75.0,18,1,1,4,6,SomeWhat Loyal
13404,2,252.49,1,2,2,5,9,Loyal
13405,3,572.451,74,3,3,2,8,SomeWhat Loyal
13408,62,28117.04,2,5,5,5,15,Champion
13410,5,1003.06,24,4,4,4,12,Loyal
13411,1,213.55,107,1,1,2,4,Others
13414,3,1390.5,134,3,4,2,9,Loyal
13416,2,712.5,44,2,3,3,8,SomeWhat Loyal
13417,2,640.83,5,2,3,5,10,Loyal
13418,18,6127.43,12,5,5,5,15,Champion
13419,1,221.06,64,1,1,3,5,SomeWhat Loyal
13420,2,159.85,150,2,1,2,5,SomeWhat Loyal
13421,2,1851.08,40,2,4,3,9,Loyal
13422,1,2626.3,64,1,5,3,9,Loyal
13425,3,1624.21,108,3,4,2,9,Loyal
13426,10,3641.32,1,5,5,5,15,Champion
13427,3,582.6,19,3,3,4,10,Loyal
13428,1,218.47,10,1,1,5,7,SomeWhat Loyal
13429,4,1006.8,11,4,4,5,13,Champion
13430,2,679.45,19,2,3,4,9,Loyal
13431,2,1269.1,67,2,4,3,9,Loyal
13434,2,534.24,74,2,3,2,7,SomeWhat Loyal
13435,7,3809.8900000000003,5,5,5,5,15,Champion
13436,1,196.89,2,1,1,5,7,SomeWhat Loyal
13437,7,3408.06,14,5,5,4,14,Champion
13439,1,283.71,255,1,2,1,4,Others
13441,1,296.64,92,1,2,2,5,SomeWhat Loyal
13447,3,1129.14,23,3,4,4,11,Loyal
13448,6,3539.37,17,5,5,4,14,Champion
13449,1,291.88,24,1,2,4,7,SomeWhat Loyal
13450,6,2043.7199999999998,27,5,4,4,13,Champion
13451,5,2976.15,26,4,5,4,13,Champion
13452,2,590.0,259,2,3,1,6,SomeWhat Loyal
13453,2,356.97999999999996,166,2,2,2,6,SomeWhat Loyal
13455,2,1058.34,25,2,4,4,10,Loyal
13456,6,1766.72,18,5,4,4,13,Champion
13458,14,9646.57,7,5,5,5,15,Champion
13460,2,183.44,29,2,1,4,7,SomeWhat Loyal
13461,3,1445.0,39,3,4,3,10,Loyal
13462,1,151.5,253,1,1,1,3,LOST
13464,1,674.68,58,1,3,3,7,SomeWhat Loyal
13466,1,307.9,184,1,2,1,4,Others
13467,2,1083.71,11,2,4,5,11,Loyal
13468,37,5704.97,2,5,5,5,15,Champion
13470,2,165.0,99,2,1,2,5,SomeWhat Loyal
13471,4,2531.58,1,4,5,5,14,Champion
13473,2,422.64,61,2,2,3,7,SomeWhat Loyal
13474,1,229.59,236,1,1,1,3,LOST
13475,4,1431.78,191,4,4,1,9,Loyal
13476,2,1238.47,179,2,4,2,8,SomeWhat Loyal
13477,6,1454.58,38,5,4,3,12,Loyal
13479,2,300.95,201,2,2,1,5,SomeWhat Loyal
13481,5,1804.56,46,4,4,3,11,Loyal
13482,1,184.64,232,1,1,1,3,LOST
13483,1,140.34,66,1,1,3,5,SomeWhat Loyal
13484,1,313.8,241,1,2,1,4,Others
13485,1,454.24,233,1,2,1,4,Others
13486,3,1122.41,78,3,4,2,9,Loyal
13487,3,575.4,58,3,3,3,9,Loyal
13488,13,8968.31,17,5,5,4,14,Champion
13489,4,449.52,105,4,2,2,8,SomeWhat Loyal
13491,10,1215.82,52,5,4,3,12,Loyal
13492,3,1269.84,136,3,4,2,9,Loyal
13493,2,618.63,275,2,3,1,6,SomeWhat Loyal
13494,1,316.26000000000005,312,1,2,1,4,Others
13495,5,2044.8700000000001,8,4,4,5,13,Champion
13496,2,653.33,11,2,3,5,10,Loyal
13497,2,348.05,283,2,2,1,5,SomeWhat Loyal
13499,5,1159.11,18,4,4,4,12,Loyal
13500,3,1166.77,23,3,4,4,11,Loyal
13501,1,1340.32,288,1,4,1,6,SomeWhat Loyal
13502,3,292.0,17,3,2,4,9,Loyal
13503,1,216.85,71,1,1,3,5,SomeWhat Loyal
13504,1,295.93,64,1,2,3,6,SomeWhat Loyal
13505,4,4393.63,73,4,5,2,11,Loyal
13506,2,458.52,316,2,2,1,5,SomeWhat Loyal
13507,4,2479.16,3,4,5,5,14,Champion
13508,1,110.97,244,1,1,1,3,LOST
13509,7,979.72,9,5,4,5,14,Champion
13510,4,1791.56,1,4,4,5,13,Champion
13512,1,251.21,261,1,2,1,4,Others
13513,1,205.1,127,1,1,2,4,Others
13514,1,152.20000000000002,74,1,1,2,4,Others
13515,4,891.12,73,4,3,2,9,Loyal
13516,3,1389.41,21,3,4,4,11,Loyal
13517,3,2128.42,60,3,5,3,11,Loyal
13518,1,659.4399999999999,86,1,3,2,6,SomeWhat Loyal
13519,1,122.75,78,1,1,2,4,Others
13520,6,3624.35,59,5,5,3,13,Champion
13521,3,1093.65,1,3,4,5,12,Loyal
13522,1,125.80000000000001,30,1,1,4,6,SomeWhat Loyal
13523,5,3964.88,33,4,5,3,12,Loyal
13524,5,680.1800000000001,41,4,3,3,10,Loyal
13525,2,628.78,15,2,3,4,9,Loyal
13527,7,2287.51,34,5,5,3,13,Champion
13529,2,307.76,79,2,2,2,6,SomeWhat Loyal
13531,2,483.8,205,2,2,1,5,SomeWhat Loyal
13532,1,210.31,34,1,1,3,5,SomeWhat Loyal
13533,3,270.79,183,3,2,1,6,SomeWhat Loyal
13534,25,5870.08,2,5,5,5,15,Champion
13536,7,3448.29,1,5,5,5,15,Champion
13538,7,1280.85,43,5,4,3,12,Loyal
13539,3,631.34,86,3,3,2,8,SomeWhat Loyal
13544,2,291.41,40,2,2,3,7,SomeWhat Loyal
13546,3,626.99,12,3,3,5,11,Loyal
13548,2,682.41,96,2,3,2,7,SomeWhat Loyal
13549,7,918.2,26,5,3,4,12,Loyal
13551,1,91.80000000000001,319,1,1,1,3,LOST
13552,12,3740.07,66,5,5,3,13,Champion
13555,4,4149.28,74,4,5,2,11,Loyal
13557,2,584.06,28,2,3,4,9,Loyal
13558,4,605.06,6,4,3,5,12,Loyal
13560,1,174.37,7,1,1,5,7,SomeWhat Loyal
13561,1,141.85999999999999,216,1,1,1,3,LOST
13562,3,1799.33,82,3,4,2,9,Loyal
13563,2,777.53,84,2,3,2,7,SomeWhat Loyal
13564,3,1749.02,144,3,4,2,9,Loyal
13565,2,240.22,19,2,1,4,7,SomeWhat Loyal
13566,2,874.71,41,2,3,3,8,SomeWhat Loyal
13568,1,192.85,173,1,1,2,4,Others
13569,2,373.75,17,2,2,4,8,SomeWhat Loyal
13570,1,239.49,243,1,1,1,3,LOST
13571,12,2092.32,13,5,5,5,15,Champion
13572,1,1384.25,206,1,4,1,6,SomeWhat Loyal
13573,2,294.4,50,2,2,3,7,SomeWhat Loyal
13575,5,732.0699999999999,23,4,3,4,11,Loyal
13576,18,6717.34,10,5,5,5,15,Champion
13577,4,1687.6000000000001,25,4,4,4,12,Loyal
13579,2,467.04,15,2,2,4,8,SomeWhat Loyal
13581,1,118.0,309,1,1,1,3,LOST
13583,1,781.03,156,1,3,2,6,SomeWhat Loyal
13584,1,142.4,307,1,1,1,3,LOST
13587,1,712.4,64,1,3,3,7,SomeWhat Loyal
13588,9,2478.95,16,5,5,4,14,Champion
13589,2,379.65,15,2,2,4,8,SomeWhat Loyal
13590,6,1981.92,11,5,4,5,14,Champion
13591,3,1117.13,65,3,4,3,10,Loyal
13592,4,247.95999999999998,36,4,1,3,8,SomeWhat Loyal
13593,5,2037.0800000000002,108,4,4,2,10,Loyal
13594,1,396.97,53,1,2,3,6,SomeWhat Loyal
13596,2,697.04,6,2,3,5,10,Loyal
13598,1,180.17000000000002,47,1,1,3,5,SomeWhat Loyal
13599,21,5153.67,1,5,5,5,15,Champion
13600,1,219.52,312,1,1,1,3,LOST
13601,2,693.32,45,2,3,3,8,SomeWhat Loyal
13602,1,428.89,65,1,2,3,6,SomeWhat Loyal
13603,1,164.34,26,1,1,4,6,SomeWhat Loyal
13606,3,280.53999999999996,29,3,2,4,9,Loyal
13607,1,678.01,40,1,3,3,7,SomeWhat Loyal
13610,7,1131.88,12,5,4,5,14,Champion
13611,3,1171.8,89,3,4,2,9,Loyal
13614,4,1610.46,24,4,4,4,12,Loyal
13615,1,417.69,319,1,2,1,4,Others
13617,3,544.18,40,3,3,3,9,Loyal
13618,1,177.34,174,1,1,2,4,Others
13621,1,213.85,117,1,1,2,4,Others
13623,5,747.78,31,4,3,4,11,Loyal
13626,1,257.23,253,1,2,1,4,Others
13627,5,1638.47,59,4,4,3,11,Loyal
13629,11,7792.36,23,5,5,4,14,Champion
13630,7,2031.78,5,5,4,5,14,Champion
13631,11,3070.42,100,5,5,2,12,Loyal
13632,5,2121.27,25,4,5,4,13,Champion
13634,5,1575.16,33,4,4,3,11,Loyal
13635,1,1071.03,68,1,4,3,8,SomeWhat Loyal
13636,5,949.12,37,4,4,3,11,Loyal
13637,3,810.5,52,3,3,3,9,Loyal
13638,1,122.64,16,1,1,4,6,SomeWhat Loyal
13639,1,1033.34,74,1,4,2,7,SomeWhat Loyal
13642,1,354.8,216,1,2,1,4,Others
13643,3,519.44,31,3,3,4,10,Loyal
13644,4,2624.26,16,4,5,4,13,Champion
13645,1,252.1,120,1,2,2,5,SomeWhat Loyal
13647,4,1678.1200000000001,10,4,4,5,13,Champion
13649,2,346.6,257,2,2,1,5,SomeWhat Loyal
13650,6,1836.34,17,5,4,4,13,Champion
13651,2,94.2,35,2,1,3,6,SomeWhat Loyal
13652,3,1095.08,46,3,4,3,10,Loyal
13654,6,2707.33,43,5,5,3,13,Champion
13655,2,932.97,114,2,3,2,7,SomeWhat Loyal
13656,2,379.65,165,2,2,2,6,SomeWhat Loyal
13657,2,382.14,11,2,2,5,9,Loyal
13658,5,2639.17,10,4,5,5,14,Champion
13659,2,1573.2,206,2,4,1,7,SomeWhat Loyal
13662,3,897.76,86,3,3,2,8,SomeWhat Loyal
13663,1,189.47,179,1,1,1,3,LOST
13666,3,84.65,60,3,1,3,7,SomeWhat Loyal
13667,1,305.02,149,1,2,2,5,SomeWhat Loyal
13668,21,6363.59,3,5,5,5,15,Champion
13669,2,218.55,51,2,1,3,6,SomeWhat Loyal
13670,1,349.7,75,1,2,2,5,SomeWhat Loyal
13672,2,186.39000000000001,301,2,1,1,4,Others
13673,2,396.92,19,2,2,4,8,SomeWhat Loyal
13675,2,486.82000000000005,151,2,2,2,6,SomeWhat Loyal
13678,1,232.6,152,1,1,2,4,Others
13680,4,3722.42,1,4,5,5,14,Champion
13681,4,827.83,18,4,3,4,11,Loyal
13682,1,59.5,187,1,1,1,3,LOST
13684,1,67.23,286,1,1,1,3,LOST
13685,7,3119.44,3,5,5,5,15,Champion
13686,1,72.0,183,1,1,1,3,LOST
13689,1,910.0,63,1,3,3,7,SomeWhat Loyal
13690,1,172.25,59,1,1,3,5,SomeWhat Loyal
13692,3,1488.32,25,3,4,4,11,Loyal
13694,50,65039.62,4,5,5,5,15,Champion
13695,15,2504.13,31,5,5,4,14,Champion
13697,1,151.29999999999998,39,1,1,3,5,SomeWhat Loyal
13699,1,308.58000000000004,155,1,2,2,5,SomeWhat Loyal
13700,10,2265.12,26,5,5,4,14,Champion
13703,1,99.5,318,1,1,1,3,LOST
13704,9,2308.06,5,5,5,5,15,Champion
13705,3,711.86,8,3,3,5,11,Loyal
13706,1,330.79,303,1,2,1,4,Others
13707,2,806.41,267,2,3,1,6,SomeWhat Loyal
13708,1,296.88,271,1,2,1,4,Others
13709,13,6328.05,4,5,5,5,15,Champion
13710,1,180.48,32,1,1,4,6,SomeWhat Loyal
13711,2,252.06,219,2,2,1,5,SomeWhat Loyal
13712,1,228.84,247,1,1,1,3,LOST
13715,5,1079.34,281,4,4,1,9,Loyal
13716,1,138.28,269,1,1,1,3,LOST
13717,6,1445.01,32,5,4,4,13,Champion
13718,2,306.55,246,2,2,1,5,SomeWhat Loyal
13719,5,1041.68,15,4,4,4,12,Loyal
13720,4,799.9,117,4,3,2,9,Loyal
13721,1,524.14,36,1,3,3,7,SomeWhat Loyal
13722,3,2375.41,132,3,5,2,10,Loyal
13723,1,199.85000000000002,217,1,1,1,3,LOST
13725,8,1980.56,50,5,4,3,12,Loyal
13726,2,1079.6599999999999,39,2,4,3,9,Loyal
13727,2,333.48,29,2,2,4,8,SomeWhat Loyal
13728,6,1016.14,37,5,4,3,12,Loyal
13730,2,752.6,136,2,3,2,7,SomeWhat Loyal
13731,2,610.59,219,2,3,1,6,SomeWhat Loyal
13732,1,491.86,28,1,3,4,8,SomeWhat Loyal
13735,4,2885.2400000000002,25,4,5,4,13,Champion
13736,2,731.9,5,2,3,5,10,Loyal
13737,1,339.59999999999997,200,1,2,1,4,Others
13739,1,216.9,18,1,1,4,6,SomeWhat Loyal
13740,1,350.75,241,1,2,1,4,Others
13741,3,668.4300000000001,72,3,3,2,8,SomeWhat Loyal
13742,12,3131.02,17,5,5,4,14,Champion
13743,7,1341.6,3,5,4,5,14,Champion
13744,2,1156.36,95,2,4,2,8,SomeWhat Loyal
13745,1,300.04,162,1,2,2,5,SomeWhat Loyal
13747,1,79.6,374,1,1,1,3,LOST
13748,5,948.25,96,4,4,2,10,Loyal
13750,5,1647.26,54,4,4,3,11,Loyal
13751,1,296.25,288,1,2,1,4,Others
13752,6,1186.28,124,5,4,2,11,Loyal
13753,1,741.26,288,1,3,1,5,SomeWhat Loyal
13754,2,282.59999999999997,152,2,2,2,6,SomeWhat Loyal
13755,9,2161.35,4,5,5,5,15,Champion
13756,14,5189.52,2,5,5,5,15,Champion
13758,7,3190.55,12,5,5,5,15,Champion
13759,2,659.4100000000001,33,2,3,3,8,SomeWhat Loyal
13760,2,286.79,54,2,2,3,7,SomeWhat Loyal
13761,2,1070.65,50,2,4,3,9,Loyal
13762,1,306.72,219,1,2,1,4,Others
13763,1,1714.96,63,1,4,3,8,SomeWhat Loyal
13764,3,1521.76,71,3,4,3,10,Loyal
13767,37,17220.36,2,5,5,5,15,Champion
13769,10,2796.51,2,5,5,5,15,Champion
13771,4,2634.45,64,4,5,3,12,Loyal
13772,3,1132.13,34,3,4,3,10,Loyal
13774,1,345.0,82,1,2,2,5,SomeWhat Loyal
13777,33,25977.16,1,5,5,5,15,Champion
13778,1,178.7,103,1,1,2,4,Others
13780,2,360.01,7,2,2,5,9,Loyal
13781,1,127.84,251,1,1,1,3,LOST
13782,6,912.0,13,5,3,5,13,Champion
13784,11,2462.79,10,5,5,5,15,Champion
13786,1,230.39999999999998,367,1,1,1,3,LOST
13787,2,309.04,76,2,2,2,6,SomeWhat Loyal
13790,1,348.8,4,1,2,5,8,SomeWhat Loyal
13791,2,1516.0,128,2,4,2,8,SomeWhat Loyal
13792,2,195.55,66,2,1,3,6,SomeWhat Loyal
13798,57,37153.85,1,5,5,5,15,Champion
13799,2,688.86,117,2,3,2,7,SomeWhat Loyal
13800,1,558.32,310,1,3,1,5,SomeWhat Loyal
13801,1,324.8,67,1,2,3,6,SomeWhat Loyal
13802,3,4599.42,139,3,5,2,10,Loyal
13803,1,277.07,255,1,2,1,4,Others
13804,7,2635.79,31,5,5,4,14,Champion
13805,2,924.6,52,2,3,3,8,SomeWhat Loyal
13806,1,256.38,64,1,2,3,6,SomeWhat Loyal
13807,1,112.6,367,1,1,1,3,LOST
13808,5,1747.66,6,4,4,5,13,Champion
13809,1,155.05,305,1,1,1,3,LOST
13810,3,1499.01,29,3,4,4,11,Loyal
13811,3,814.5,184,3,3,1,7,SomeWhat Loyal
13812,3,539.0,42,3,3,3,9,Loyal
13813,4,1366.8600000000001,40,4,4,3,11,Loyal
13814,2,1579.12,92,2,4,2,8,SomeWhat Loyal
13815,4,4027.36,22,4,5,4,13,Champion
13816,2,571.6700000000001,24,2,3,4,9,Loyal
13817,2,382.98,29,2,2,4,8,SomeWhat Loyal
13819,3,1140.35,302,3,4,1,8,SomeWhat Loyal
13821,2,385.64,145,2,2,2,6,SomeWhat Loyal
13822,2,632.0,6,2,3,5,10,Loyal
13823,2,957.66,19,2,4,4,10,Loyal
13824,5,1698.94,33,4,4,3,11,Loyal
13826,1,189.5,176,1,1,2,4,Others
13827,3,412.05,58,3,2,3,8,SomeWhat Loyal
13828,1,209.49,22,1,1,4,6,SomeWhat Loyal
13831,6,2202.99,16,5,5,4,14,Champion
13832,1,52.199999999999996,19,1,1,4,6,SomeWhat Loyal
13833,1,384.8,159,1,2,2,5,SomeWhat Loyal
13835,4,834.57,25,4,3,4,11,Loyal
13837,2,271.24,212,2,2,1,5,SomeWhat Loyal
13838,4,691.73,6,4,3,5,12,Loyal
13841,1,85.0,253,1,1,1,3,LOST
13842,9,3385.62,59,5,5,3,13,Champion
13844,1,361.62,11,1,2,5,8,SomeWhat Loyal
13845,1,312.98,65,1,2,3,6,SomeWhat Loyal
13846,3,865.0600000000001,25,3,3,4,10,Loyal
13848,3,1255.0,92,3,4,2,9,Loyal
13849,2,1537.95,52,2,4,3,9,Loyal
13850,1,1595.48,129,1,4,2,7,SomeWhat Loyal
13851,3,2651.46,96,3,5,2,10,Loyal
13853,1,1090.14,57,1,4,3,8,SomeWhat Loyal
13854,25,8109.5199999999995,9,5,5,5,15,Champion
13856,3,388.5,169,3,2,2,7,SomeWhat Loyal
13858,1,216.17,57,1,1,3,5,SomeWhat Loyal
13859,1,201.16,326,1,1,1,3,LOST
13860,5,1245.9,1,4,4,5,13,Champion
13862,8,2209.36,18,5,5,4,14,Champion
13863,1,305.78,248,1,2,1,4,Others
13865,4,501.56,58,4,3,3,10,Loyal
13866,1,145.67000000000002,74,1,1,2,4,Others
13867,3,1015.29,31,3,4,4,11,Loyal
13868,2,3192.54,7,2,5,5,12,Loyal
13869,4,3104.95,123,4,5,2,11,Loyal
13870,8,2770.94,2,5,5,5,15,Champion
13871,13,6403.25,23,5,5,4,14,Champion
13873,3,389.6,120,3,2,2,7,SomeWhat Loyal
13874,1,540.45,358,1,3,1,5,SomeWhat Loyal
13875,5,1786.79,54,4,4,3,11,Loyal
13876,1,122.7,64,1,1,3,5,SomeWhat Loyal
13877,1,117.24,86,1,1,2,4,Others
13878,1,1281.53,55,1,4,3,8,SomeWhat Loyal
13880,13,3219.77,21,5,5,4,14,Champion
13881,20,17159.52,4,5,5,5,15,Champion
13882,5,1191.13,3,4,4,5,13,Champion
13883,5,2674.48,11,4,5,5,14,Champion
13884,5,787.6,7,4,3,5,12,Loyal
13885,2,506.8,189,2,3,1,6,SomeWhat Loyal
13886,1,243.56,71,1,1,3,5,SomeWhat Loyal
13887,1,349.55,204,1,2,1,4,Others
13888,2,605.63,120,2,3,2,7,SomeWhat Loyal
13889,1,416.90000000000003,93,1,2,2,5,SomeWhat Loyal
13890,10,1883.8100000000002,1,5,4,5,14,Champion
13892,4,632.97,27,4,3,4,11,Loyal
13893,1,821.1,298,1,3,1,5,SomeWhat Loyal
13894,3,564.62,24,3,3,4,10,Loyal
13895,4,2593.07,28,4,5,4,13,Champion
13897,1,311.16,50,1,2,3,6,SomeWhat Loyal
13898,1,155.93,326,1,1,1,3,LOST
13899,2,388.52,16,2,2,4,8,SomeWhat Loyal
13900,3,740.95,183,3,3,1,7,SomeWhat Loyal
13901,5,2867.2,72,4,5,2,11,Loyal
13904,2,332.64,37,2,2,3,7,SomeWhat Loyal
13908,4,2369.55,80,4,5,2,11,Loyal
13911,9,2580.91,57,5,5,3,13,Champion
13914,2,626.45,12,2,3,5,10,Loyal
13917,2,272.04,50,2,2,3,7,SomeWhat Loyal
13918,2,1212.8400000000001,50,2,4,3,9,Loyal
13919,2,384.81,59,2,2,3,7,SomeWhat Loyal
13922,1,172.25,352,1,1,1,3,LOST
13923,1,351.13,54,1,2,3,6,SomeWhat Loyal
13924,6,1838.8500000000001,2,5,4,5,14,Champion
13925,4,678.25,93,4,3,2,9,Loyal
13926,1,223.85000000000002,23,1,1,4,6,SomeWhat Loyal
13927,1,348.99,75,1,2,2,5,SomeWhat Loyal
13928,4,464.57,11,4,2,5,11,Loyal
13929,2,842.65,169,2,3,2,7,SomeWhat Loyal
13930,2,337.34,58,2,2,3,7,SomeWhat Loyal
13931,2,1237.53,96,2,4,2,8,SomeWhat Loyal
13932,1,307.4,295,1,2,1,4,Others
13933,2,608.7900000000001,109,2,3,2,7,SomeWhat Loyal
13934,1,922.1,264,1,3,1,5,SomeWhat Loyal
13936,1,376.58,180,1,2,1,4,Others
13937,1,158.85,169,1,1,2,4,Others
13938,1,71.66,35,1,1,3,5,SomeWhat Loyal
13939,3,568.55,23,3,3,4,10,Loyal
13940,4,839.14,17,4,3,4,11,Loyal
13941,5,5112.96,22,4,5,4,13,Champion
13946,3,561.5699999999999,79,3,3,2,8,SomeWhat Loyal
13947,1,90.6,65,1,1,3,5,SomeWhat Loyal
13948,1,102.0,361,1,1,1,3,LOST
13949,6,2427.32,3,5,5,5,15,Champion
13950,4,745.06,11,4,3,5,12,Loyal
13951,3,674.45,176,3,3,2,8,SomeWhat Loyal
13952,2,3251.071,218,2,5,1,8,SomeWhat Loyal
13953,7,3515.68,7,5,5,5,15,Champion
13954,2,439.92,2,3,2,5,10,Loyal
13955,2,322.96,154,3,2,2,7,SomeWhat Loyal
13956,5,1026.42,5,4,4,5,13,Champion
13959,3,598.2,79,3,3,2,8,SomeWhat Loyal
13960,2,230.22,21,3,1,4,8,SomeWhat Loyal
13962,2,169.55,22,3,1,4,8,SomeWhat Loyal
13963,4,664.54,308,4,3,1,8,SomeWhat Loyal
13967,1,80.7,146,1,1,2,4,Others
13969,18,9053.94,7,5,5,5,15,Champion
13971,8,2758.26,19,5,5,4,14,Champion
13972,2,190.25,71,3,1,3,7,SomeWhat Loyal
13973,1,264.7,287,1,2,1,4,Others
13974,1,413.59000000000003,49,1,2,3,6,SomeWhat Loyal
13975,6,2526.28,31,5,5,4,14,Champion
13976,1,357.98,207,1,2,1,4,Others
13978,2,196.79000000000002,15,3,1,4,8,SomeWhat Loyal
13979,1,869.87,73,1,3,2,6,SomeWhat Loyal
13980,1,200.14,60,1,1,3,5,SomeWhat Loyal
13982,4,1871.81,39,4,4,3,11,Loyal
13983,12,2603.43,30,5,5,4,14,Champion
13984,5,920.51,27,4,3,4,11,Loyal
13985,15,7060.13,4,5,5,5,15,Champion
13986,1,320.46,17,1,2,4,7,SomeWhat Loyal
13988,6,4147.96,20,5,5,4,14,Champion
13989,2,1266.08,66,3,4,3,10,Loyal
13990,1,311.3,213,1,2,1,4,Others
13991,6,855.97,12,5,3,5,13,Champion
13992,1,76.8,30,1,1,4,6,SomeWhat Loyal
13993,9,3466.36,43,5,5,3,13,Champion
13994,6,2313.14,4,5,5,5,15,Champion
13995,5,1393.69,15,4,4,4,12,Loyal
13999,12,3901.81,10,5,5,5,15,Champion
14000,1,635.66,211,1,3,1,5,SomeWhat Loyal
14001,3,2043.0800000000002,46,3,4,3,10,Loyal
14002,2,529.73,134,3,3,2,8,SomeWhat Loyal
14004,7,4582.64,43,5,5,3,13,Champion
14005,5,2874.72,10,4,5,5,14,Champion
14006,3,962.19,116,3,4,2,9,Loyal
14009,2,695.61,198,3,3,1,7,SomeWhat Loyal
14012,1,328.8,278,1,2,1,4,Others
14013,3,473.02,110,3,2,2,7,SomeWhat Loyal
14014,1,505.18,77,1,3,2,6,SomeWhat Loyal
14015,1,917.34,53,1,3,3,7,SomeWhat Loyal
14016,4,4341.21,162,4,5,2,11,Loyal
14019,3,1421.61,47,3,4,3,10,Loyal
14020,2,642.8,17,3,3,4,10,Loyal
14021,3,631.9,155,3,3,2,8,SomeWhat Loyal
14022,1,440.0,225,1,2,1,4,Others
14023,2,584.07,7,3,3,5,11,Loyal
14024,2,327.7,122,3,2,2,7,SomeWhat Loyal
14027,1,104.82,61,1,1,3,5,SomeWhat Loyal
14029,2,467.66,63,3,2,3,8,SomeWhat Loyal
14030,8,2360.09,18,5,5,4,14,Champion
14031,19,17286.86,7,5,5,5,15,Champion
14032,11,2975.59,2,5,5,5,15,Champion
14034,3,651.8199999999999,22,3,3,4,10,Loyal
14035,5,1428.02,29,4,4,4,12,Loyal
14036,1,626.65,285,1,3,1,5,SomeWhat Loyal
14037,2,147.20000000000002,176,3,1,2,6,SomeWhat Loyal
14038,3,1560.38,78,3,4,2,9,Loyal
14039,1,152.2,33,1,1,3,5,SomeWhat Loyal
14040,12,3614.92,41,5,5,3,13,Champion
14041,1,141.41,266,1,1,1,3,LOST
14044,4,652.82,27,4,3,4,11,Loyal
14045,4,1659.75,109,4,4,2,10,Loyal
14046,1,154.99,284,1,1,1,3,LOST
14047,5,1308.6100000000001,9,4,4,5,13,Champion
14048,1,409.93,305,1,2,1,4,Others
14049,4,5681.72,17,4,5,4,13,Champion
14050,2,746.36,32,3,3,4,10,Loyal
14051,23,15610.390000000001,1,5,5,5,15,Champion
14052,1,225.36,20,1,1,4,6,SomeWhat Loyal
14053,2,260.25,124,3,2,2,7,SomeWhat Loyal
14054,1,92.46,65,1,1,3,5,SomeWhat Loyal
14055,1,725.6400000000001,106,1,3,2,6,SomeWhat Loyal
14056,23,8214.65,1,5,5,5,15,Champion
14057,17,6217.96,24,5,5,4,14,Champion
14059,1,183.6,267,1,1,1,3,LOST
14060,19,6140.42,5,5,5,5,15,Champion
14062,12,10464.85,10,5,5,5,15,Champion
14064,5,1353.74,29,4,4,4,12,Loyal
14066,1,152.55,267,1,1,1,3,LOST
14067,2,374.7,64,3,2,3,8,SomeWhat Loyal
14068,1,265.85,320,1,2,1,4,Others
14071,8,1438.82,4,5,4,5,14,Champion
14073,1,151.04,32,1,1,4,6,SomeWhat Loyal
14075,3,942.26,5,3,3,5,11,Loyal
14076,1,122.47,129,1,1,2,4,Others
14077,5,499.41999999999996,41,4,3,3,10,Loyal
14078,6,1049.37,102,5,4,2,11,Loyal
14079,1,375.1,125,1,2,2,5,SomeWhat Loyal
14080,1,45.599999999999994,33,1,1,3,5,SomeWhat Loyal
14081,2,934.52,302,3,3,1,7,SomeWhat Loyal
14082,1,182.25,365,1,1,1,3,LOST
14083,9,1018.43,4,5,4,5,14,Champion
14085,18,4448.54,2,5,5,5,15,Champion
14087,1,194.42,3,1,1,5,7,SomeWhat Loyal
14088,13,50491.81,10,5,5,5,15,Champion
14089,1,161.0,57,1,1,3,5,SomeWhat Loyal
14090,1,76.32000000000001,325,1,1,1,3,LOST
14092,14,4076.91,8,5,5,5,15,Champion
14093,1,442.85,12,1,2,5,8,SomeWhat Loyal
14096,17,65164.79,4,5,5,5,15,Champion
14098,1,147.35,37,1,1,3,5,SomeWhat Loyal
14099,11,3104.17,16,5,5,4,14,Champion
14100,1,194.9,138,1,1,2,4,Others
14101,6,5976.79,74,5,5,2,12,Loyal
14102,5,1360.28,5,4,4,5,13,Champion
14104,2,216.20999999999998,155,3,1,2,6,SomeWhat Loyal
14105,1,1266.23,239,1,4,1,6,SomeWhat Loyal
14107,7,2703.23,52,5,5,3,13,Champion
14108,2,597.91,31,3,3,4,10,Loyal
14109,1,144.2,73,1,1,2,4,Others
14110,12,5683.15,4,5,5,5,15,Champion
14111,4,692.85,14,4,3,4,11,Loyal
14112,7,2915.15,23,5,5,4,14,Champion
14113,4,1840.42,4,4,4,5,13,Champion
14114,2,386.53,274,3,2,1,6,SomeWhat Loyal
14116,5,1382.74,20,4,4,4,12,Loyal
14117,1,90.0,144,1,1,2,4,Others
14121,4,2780.15,4,4,5,5,14,Champion
14124,1,419.58000000000004,84,1,2,2,5,SomeWhat Loyal
14125,3,2740.43,11,3,5,5,13,Champion
14126,3,706.1300000000001,8,3,3,5,11,Loyal
14127,3,709.71,123,3,3,2,8,SomeWhat Loyal
14128,2,637.5,61,3,3,3,9,Loyal
14129,5,1123.8600000000001,2,4,4,5,13,Champion
14130,1,483.86,319,1,2,1,4,Others
14132,11,3586.0299999999997,2,5,5,5,15,Champion
14133,3,605.64,130,3,3,2,8,SomeWhat Loyal
14135,15,4690.31,2,5,5,5,15,Champion
14138,2,982.3800000000001,2,3,4,5,12,Loyal
14139,1,415.82,46,1,2,3,6,SomeWhat Loyal
14140,2,935.05,4,3,3,5,11,Loyal
14141,4,915.13,3,4,3,5,12,Loyal
14142,1,311.81,373,1,2,1,4,Others
14143,1,115.8,134,1,1,2,4,Others
14145,4,3742.2,47,4,5,3,12,Loyal
14146,5,4191.0,9,4,5,5,14,Champion
14147,2,483.4,78,3,2,2,7,SomeWhat Loyal
14148,1,157.2,234,1,1,1,3,LOST
14149,1,446.62,221,1,2,1,4,Others
14150,2,658.64,36,3,3,3,9,Loyal
14152,2,621.29,75,3,3,2,8,SomeWhat Loyal
14154,2,1345.62,239,3,4,1,8,SomeWhat Loyal
14155,1,118.75,266,1,1,1,3,LOST
14156,55,117379.63,10,5,5,5,15,Champion
14157,2,432.88,20,3,2,4,9,Loyal
14158,1,507.66,40,1,3,3,7,SomeWhat Loyal
14159,11,4693.01,20,5,5,4,14,Champion
14161,3,1110.52,216,3,4,1,8,SomeWhat Loyal
14162,2,289.36,174,3,2,2,7,SomeWhat Loyal
14163,4,2445.91,87,4,5,2,11,Loyal
14164,2,1631.77,71,3,4,3,10,Loyal
14165,1,122.53999999999999,276,1,1,1,3,LOST
14167,4,574.84,39,4,3,3,10,Loyal
14171,1,363.79,98,1,2,2,5,SomeWhat Loyal
14173,4,450.84,11,4,2,5,11,Loyal
14174,1,134.46,33,1,1,3,5,SomeWhat Loyal
14175,3,3222.3,60,3,5,3,11,Loyal
14176,4,576.9000000000001,297,4,3,1,8,SomeWhat Loyal
14177,4,559.41,86,4,3,2,9,Loyal
14178,7,1620.93,9,5,4,5,14,Champion
14179,2,719.78,41,3,3,3,9,Loyal
14180,25,4748.52,11,5,5,5,15,Champion
14184,1,452.89,67,1,2,3,6,SomeWhat Loyal
14185,1,197.65,331,1,1,1,3,LOST
14188,6,2054.36,31,5,4,4,13,Champion
14189,15,4654.08,2,5,5,5,15,Champion
14191,13,4684.76,2,5,5,5,15,Champion
14193,2,853.39,68,3,3,3,9,Loyal
14194,21,11349.52,5,5,5,5,15,Champion
14195,2,1012.0,202,3,4,1,8,SomeWhat Loyal
14196,1,335.52,107,1,2,2,5,SomeWhat Loyal
14198,4,701.4,18,4,3,4,11,Loyal
14199,1,185.39999999999998,218,1,1,1,3,LOST
14201,7,747.44,60,5,3,3,11,Loyal
14204,1,161.03,2,1,1,5,7,SomeWhat Loyal
14205,2,466.7,17,3,2,4,9,Loyal
14206,1,328.15999999999997,239,1,2,1,4,Others
14208,1,151.74,95,1,1,2,4,Others
14209,6,2073.43,11,5,5,5,15,Champion
14210,6,1905.8400000000001,106,5,4,2,11,Loyal
14211,9,2241.1,53,5,5,3,13,Champion
14212,1,1070.48,90,1,4,2,7,SomeWhat Loyal
14214,5,1004.38,31,4,4,4,12,Loyal
14215,6,1789.72,12,5,4,5,14,Champion
14216,4,1839.3,3,4,4,5,13,Champion
14217,17,2004.98,2,5,4,5,14,Champion
14218,1,169.48000000000002,43,1,1,3,5,SomeWhat Loyal
14219,1,89.94,4,1,1,5,7,SomeWhat Loyal
14220,2,632.4,247,3,3,1,7,SomeWhat Loyal
14221,9,3432.8,42,5,5,3,13,Champion
14222,1,683.17,177,1,3,2,6,SomeWhat Loyal
14223,3,991.13,92,3,4,2,9,Loyal
14224,4,1050.12,110,4,4,2,10,Loyal
14226,5,2232.19,29,4,5,4,13,Champion
14227,10,3350.96,26,5,5,4,14,Champion
14229,3,1547.2,52,3,4,3,10,Loyal
14231,3,925.71,184,3,3,1,7,SomeWhat Loyal
14232,5,2048.07,43,4,4,3,11,Loyal
14233,4,1462.72,49,4,4,3,11,Loyal
14234,4,775.46,22,4,3,4,11,Loyal
14235,5,3144.86,75,4,5,2,11,Loyal
14236,2,490.86,81,3,3,2,8,SomeWhat Loyal
14237,1,161.0,373,1,1,1,3,LOST
14238,1,146.85,326,1,1,1,3,LOST
14239,11,2380.85,43,5,5,3,13,Champion
14240,2,890.34,30,3,3,4,10,Loyal
14241,1,213.70000000000002,184,1,1,1,3,LOST
14242,2,280.55,235,3,2,1,6,SomeWhat Loyal
14243,10,2588.77,9,5,5,5,15,Champion
14245,2,1693.45,220,3,4,1,8,SomeWhat Loyal
14246,3,1474.06,111,3,4,2,9,Loyal
14247,1,136.76999999999998,278,1,1,1,3,LOST
14248,1,302.58,318,1,2,1,4,Others
14250,3,1904.05,7,3,4,5,12,Loyal
14251,5,2879.7000000000003,2,4,5,5,14,Champion
14256,2,969.0600000000001,260,3,4,1,8,SomeWhat Loyal
14257,5,3099.7200000000003,64,4,5,3,12,Loyal
14258,9,12669.98,9,5,5,5,15,Champion
14259,1,120.0,142,1,1,2,4,Others
14261,2,1163.45,51,3,4,3,10,Loyal
14262,8,2618.23,8,5,5,5,15,Champion
14264,2,333.97,155,3,2,2,7,SomeWhat Loyal
14265,2,530.18,109,3,3,2,8,SomeWhat Loyal
14267,3,1516.24,163,3,4,2,9,Loyal
14270,1,492.65000000000003,332,1,3,1,5,SomeWhat Loyal
14271,1,112.32,226,1,1,1,3,LOST
14272,2,437.96,74,3,2,2,7,SomeWhat Loyal
14273,4,559.97,51,4,3,3,10,Loyal
14276,3,1119.74,99,3,4,2,9,Loyal
14277,3,4216.2,15,3,5,4,12,Loyal
14280,1,134.04,197,1,1,1,3,LOST
14282,15,3729.34,3,5,5,5,15,Champion
14284,2,595.25,31,3,3,4,10,Loyal
14285,4,1910.01,21,4,4,4,12,Loyal
14286,3,4628.75,24,3,5,4,12,Loyal
14287,3,176.63,8,3,1,5,9,Loyal
14288,1,426.6,213,1,2,1,4,Others
14289,6,911.26,9,5,3,5,13,Champion
14290,5,2314.65,11,4,5,5,14,Champion
14291,11,3883.25,2,5,5,5,15,Champion
14292,9,4871.93,8,5,5,5,15,Champion
14293,4,1046.56,3,4,4,5,13,Champion
14295,1,166.20000000000002,40,1,1,3,5,SomeWhat Loyal
14297,4,1305.33,18,4,4,4,12,Loyal
14298,44,51527.3,8,5,5,5,15,Champion
14299,9,3965.62,8,5,5,5,15,Champion
14300,1,43.2,19,1,1,4,6,SomeWhat Loyal
14301,1,640.14,117,1,3,2,6,SomeWhat Loyal
14304,1,383.45,223,1,2,1,4,Others
14305,3,1858.96,71,3,4,3,10,Loyal
14306,2,2093.32,51,3,5,3,11,Loyal
14307,6,2995.72,89,5,5,2,12,Loyal
14309,9,2352.53,8,5,5,5,15,Champion
14311,1,310.26,243,1,2,1,4,Others
14312,6,1611.59,47,5,4,3,12,Loyal
14314,1,120.0,107,1,1,2,4,Others
14315,6,2481.13,45,5,5,3,13,Champion
14317,1,508.58000000000004,65,1,3,3,7,SomeWhat Loyal
14320,2,477.79,207,3,2,1,6,SomeWhat Loyal
14321,5,1530.75,11,4,4,5,13,Champion
14323,2,605.0600000000001,115,3,3,2,8,SomeWhat Loyal
14326,1,183.85,242,1,1,1,3,LOST
14327,1,311.65,163,1,2,2,5,SomeWhat Loyal
14329,7,5014.84,17,5,5,4,14,Champion
14331,2,462.65999999999997,124,3,2,2,7,SomeWhat Loyal
14332,3,866.31,23,3,3,4,10,Loyal
14333,1,415.2,68,1,2,3,6,SomeWhat Loyal
14334,8,2552.21,17,5,5,4,14,Champion
14335,2,468.26,16,3,2,4,9,Loyal
14336,4,1614.91,17,4,4,4,12,Loyal
14338,2,588.22,161,3,3,2,8,SomeWhat Loyal
14339,1,309.52,243,1,2,1,4,Others
14340,1,134.7,219,1,1,1,3,LOST
14341,8,2182.28,45,5,5,3,13,Champion
14342,4,668.5600000000001,21,4,3,4,11,Loyal
14344,8,889.9300000000001,127,5,3,2,10,Loyal
14345,1,108.97999999999999,39,1,1,3,5,SomeWhat Loyal
14346,2,1021.58,121,3,4,2,9,Loyal
14348,1,409.57,260,1,2,1,4,Others
14349,1,133.5,10,1,1,5,7,SomeWhat Loyal
14350,1,282.93,274,1,2,1,4,Others
14351,1,51.0,165,1,1,2,4,Others
14352,4,1078.96,157,4,4,2,10,Loyal
14353,1,90.6,215,1,1,1,3,LOST
14354,2,163.62,6,3,1,5,9,Loyal
14355,1,174.4,366,1,1,1,3,LOST
14356,2,701.23,80,3,3,2,8,SomeWhat Loyal
14357,1,225.77,43,1,1,3,5,SomeWhat Loyal
14359,3,912.18,19,3,3,4,10,Loyal
14360,4,2128.23,32,4,5,4,13,Champion
14362,1,161.2,22,1,1,4,6,SomeWhat Loyal
14364,8,3717.35,109,5,5,2,12,Loyal
14367,16,9261.52,8,5,5,5,15,Champion
14368,1,155.0,320,1,1,1,3,LOST
14371,1,100.5,295,1,1,1,3,LOST
14373,1,76.55,358,1,1,1,3,LOST
14375,1,257.68,185,1,2,1,4,Others
14377,2,617.05,191,3,3,1,7,SomeWhat Loyal
14379,2,348.1,44,3,2,3,8,SomeWhat Loyal
14381,1,202.68,52,1,1,3,5,SomeWhat Loyal
14382,1,626.0699999999999,26,1,3,4,8,SomeWhat Loyal
14383,3,1247.69,38,3,4,3,10,Loyal
14385,3,202.11,9,3,1,5,9,Loyal
14386,1,142.4,297,1,1,1,3,LOST
14387,3,1770.56,33,3,4,3,10,Loyal
14388,8,3212.84,10,5,5,5,15,Champion
14389,2,1043.46,65,3,4,3,10,Loyal
14390,9,4652.82,10,5,5,5,15,Champion
14393,1,67.95,218,1,1,1,3,LOST
14395,9,3507.71,2,5,5,5,15,Champion
14396,2,487.99,65,3,2,3,8,SomeWhat Loyal
14397,19,2612.96,3,5,5,5,15,Champion
14400,1,574.7,149,1,3,2,6,SomeWhat Loyal
14401,13,4051.48,4,5,5,5,15,Champion
14403,4,1475.81,130,4,4,2,10,Loyal
14404,6,1474.32,34,5,4,3,12,Loyal
14406,1,156.75,119,1,1,2,4,Others
14407,6,2157.73,107,5,5,2,12,Loyal
14408,7,2606.53,11,5,5,5,15,Champion
14409,6,2059.4500000000003,71,5,5,3,13,Champion
14410,9,1105.07,92,5,4,2,11,Loyal
14411,1,1063.0,311,1,4,1,6,SomeWhat Loyal
14412,2,770.03,43,3,3,3,9,Loyal
14413,1,122.7,362,1,1,1,3,LOST
14414,7,1496.98,92,5,4,2,11,Loyal
14415,13,5900.28,1,5,5,5,15,Champion
14416,2,490.22,22,3,3,4,10,Loyal
14418,3,1937.25,4,3,4,5,12,Loyal
14419,6,1058.06,11,5,4,5,14,Champion
14420,1,387.52,99,1,2,2,5,SomeWhat Loyal
14421,2,813.11,57,3,3,3,9,Loyal
14422,6,4263.64,1,5,5,5,15,Champion
14423,1,265.2,218,1,2,1,4,Others
14424,1,322.08,18,1,2,4,7,SomeWhat Loyal
14426,10,4481.67,24,5,5,4,14,Champion
14427,2,363.34000000000003,50,3,2,3,8,SomeWhat Loyal
14428,5,1244.83,7,4,4,5,13,Champion
14431,1,470.36,303,1,2,1,4,Others
14432,6,2255.51,10,5,5,5,15,Champion
14434,6,1372.8,22,5,4,4,13,Champion
14436,1,89.06,99,1,1,2,4,Others
14437,1,63.0,366,1,1,1,3,LOST
14438,1,131.9,306,1,1,1,3,LOST
14439,1,2661.24,320,1,5,1,7,SomeWhat Loyal
14440,5,2357.6800000000003,8,4,5,5,14,Champion
14441,4,1712.89,1,4,4,5,13,Champion
14442,2,1589.82,205,3,4,1,8,SomeWhat Loyal
14443,4,1420.2,54,4,4,3,11,Loyal
14446,4,1039.58,1,4,4,5,13,Champion
14447,5,1163.23,19,4,4,4,12,Loyal
14448,2,375.35,9,3,2,5,10,Loyal
14449,4,907.1,19,4,3,4,11,Loyal
14450,3,483.25,181,3,2,1,6,SomeWhat Loyal
14451,2,662.59,60,3,3,3,9,Loyal
14452,2,264.44,11,3,2,5,10,Loyal
14453,1,119.93,190,1,1,1,3,LOST
14456,9,3062.4,5,5,5,5,15,Champion
14457,1,113.64,311,1,1,1,3,LOST
14459,1,1837.92,155,1,4,2,7,SomeWhat Loyal
14460,3,434.34,110,3,2,2,7,SomeWhat Loyal
14461,3,2103.06,148,3,5,2,10,Loyal
14462,11,2004.02,66,5,4,3,12,Loyal
14463,3,529.62,98,3,3,2,8,SomeWhat Loyal
14465,3,1058.6200000000001,247,3,4,1,8,SomeWhat Loyal
14466,7,2272.4,29,5,5,4,14,Champion
14467,4,598.76,18,4,3,4,11,Loyal
14470,2,461.19,12,3,2,5,10,Loyal
14472,8,1936.84,104,5,4,2,11,Loyal
14473,2,234.34000000000003,74,3,1,2,6,SomeWhat Loyal
14474,1,547.66,46,1,3,3,7,SomeWhat Loyal
14475,3,925.85,72,3,3,2,8,SomeWhat Loyal
14476,1,215.7,257,1,1,1,3,LOST
14477,4,1309.6,20,4,4,4,12,Loyal
14479,2,316.25,254,3,2,1,6,SomeWhat Loyal
14480,1,279.05,11,1,2,5,8,SomeWhat Loyal
14481,2,636.51,165,3,3,2,8,SomeWhat Loyal
14482,6,2068.15,18,5,5,4,14,Champion
14483,1,137.1,282,1,1,1,3,LOST
14484,1,321.92,50,1,2,3,6,SomeWhat Loyal
14485,1,165.75,39,1,1,3,5,SomeWhat Loyal
14487,6,1196.33,27,5,4,4,13,Champion
14488,1,1064.28,68,1,4,3,8,SomeWhat Loyal
14489,1,463.38,207,1,2,1,4,Others
14491,2,340.93,175,3,2,2,7,SomeWhat Loyal
14493,5,2383.2400000000002,7,4,5,5,14,Champion
14494,1,139.56,26,1,1,4,6,SomeWhat Loyal
14495,2,123.8,51,3,1,3,7,SomeWhat Loyal
14496,2,538.8100000000001,312,3,3,1,7,SomeWhat Loyal
14497,1,475.37,309,1,2,1,4,Others
14498,5,1957.32,43,4,4,3,11,Loyal
14499,3,815.32,26,3,3,4,10,Loyal
14500,3,356.85,88,3,2,2,7,SomeWhat Loyal
14501,2,251.21,184,3,2,1,6,SomeWhat Loyal
14502,11,2470.67,20,5,5,4,14,Champion
14503,6,3543.26,3,5,5,5,15,Champion
14504,4,673.26,47,4,3,3,10,Loyal
14505,8,5905.64,17,5,5,4,14,Champion
14506,5,2012.17,17,4,4,4,12,Loyal
14507,6,1383.18,24,5,4,4,13,Champion
14508,2,276.42,22,3,2,4,9,Loyal
14511,5,1314.81,11,4,4,5,13,Champion
14512,2,275.28,188,3,2,1,6,SomeWhat Loyal
14513,3,455.59000000000003,101,3,2,2,7,SomeWhat Loyal
14514,3,1055.35,61,3,4,3,10,Loyal
14515,6,2102.09,18,5,5,4,14,Champion
14517,2,330.45,33,3,2,3,8,SomeWhat Loyal
14518,1,174.37,64,1,1,3,5,SomeWhat Loyal
14520,2,270.6,2,3,2,5,10,Loyal
14522,4,974.54,24,4,4,4,12,Loyal
14523,1,241.09,108,1,1,2,4,Others
14524,9,1867.68,32,5,4,4,13,Champion
14525,9,4332.2,20,5,5,4,14,Champion
14527,55,8508.82,3,5,5,5,15,Champion
14528,1,364.21999999999997,37,1,2,3,6,SomeWhat Loyal
14529,3,620.04,60,3,3,3,9,Loyal
14530,6,2925.91,26,5,5,4,14,Champion
14532,4,932.85,236,4,3,1,8,SomeWhat Loyal
14533,7,1949.72,25,5,4,4,13,Champion
14534,18,4447.05,3,5,5,5,15,Champion
14535,3,2864.19,60,3,5,3,11,Loyal
14536,1,171.8,260,1,1,1,3,LOST
14537,1,355.56,58,1,2,3,6,SomeWhat Loyal
14538,2,388.25,65,3,2,3,8,SomeWhat Loyal
14539,2,537.48,16,3,3,4,10,Loyal
14540,3,996.26,10,3,4,5,12,Loyal
14541,8,1461.65,59,5,4,3,12,Loyal
14542,1,103.25,186,1,1,1,3,LOST
14543,16,3630.33,29,5,5,4,14,Champion
14544,2,2024.45,24,3,4,4,11,Loyal
14546,5,2578.09,5,4,5,5,14,Champion
14547,8,4007.54,4,5,5,5,15,Champion
14548,2,652.8,151,3,3,2,8,SomeWhat Loyal
14549,1,289.24,311,1,2,1,4,Others
14550,2,765.62,11,3,3,5,11,Loyal
14551,2,186.23,18,3,1,4,8,SomeWhat Loyal
14552,1,165.07,152,1,1,2,4,Others
14553,5,859.27,19,4,3,4,11,Loyal
14554,4,2381.04,10,4,5,5,14,Champion
14555,2,324.14,57,3,2,3,8,SomeWhat Loyal
14557,1,788.38,85,1,3,2,6,SomeWhat Loyal
14560,22,2237.77,7,5,5,5,15,Champion
14561,3,1080.76,76,3,4,2,9,Loyal
14562,18,5074.77,4,5,5,5,15,Champion
14565,4,3099.12,96,4,5,2,11,Loyal
14566,1,1432.0,111,1,4,2,7,SomeWhat Loyal
14567,2,1530.3600000000001,57,3,4,3,10,Loyal
14569,1,227.39,1,1,1,5,7,SomeWhat Loyal
14570,2,218.06,281,3,1,1,5,SomeWhat Loyal
14572,7,2832.84,3,5,5,5,15,Champion
14573,9,1653.42,180,5,4,1,10,Loyal
14576,1,35.400000000000006,372,1,1,1,3,LOST
14577,4,859.71,13,4,3,5,12,Loyal
14578,1,168.63,3,1,1,5,7,SomeWhat Loyal
14581,1,138.6,17,1,1,4,6,SomeWhat Loyal
14582,1,114.11,41,1,1,3,5,SomeWhat Loyal
14583,5,1052.55,6,4,4,5,13,Champion
14584,4,1042.26,169,4,4,2,10,Loyal
14585,1,157.05,50,1,1,3,5,SomeWhat Loyal
14586,1,237.36,277,1,1,1,3,LOST
14587,9,1601.14,19,5,4,4,13,Champion
14589,1,39.75,372,1,1,1,3,LOST
14591,4,1447.14,15,4,4,4,12,Loyal
14592,3,570.46,35,3,3,3,9,Loyal
14593,3,617.99,22,3,3,4,10,Loyal
14594,2,379.83,7,3,2,5,10,Loyal
14595,6,1740.6,20,5,4,4,13,Champion
14597,2,883.15,11,3,3,5,11,Loyal
14598,1,221.97,44,1,1,3,5,SomeWhat Loyal
14600,1,393.33000000000004,306,1,2,1,4,Others
14601,1,213.96,11,1,1,5,7,SomeWhat Loyal
14603,1,660.0,275,1,3,1,5,SomeWhat Loyal
14606,93,12156.65,1,5,5,5,15,Champion
14607,14,16569.5,16,5,5,4,14,Champion
14608,4,1785.15,4,4,4,5,13,Champion
14609,4,601.56,72,4,3,2,9,Loyal
14616,3,406.08000000000004,243,3,2,1,6,SomeWhat Loyal
14618,3,553.44,9,3,3,5,11,Loyal
14619,1,394.44,246,1,2,1,4,Others
14620,2,412.78000000000003,206,3,2,1,6,SomeWhat Loyal
14621,5,1788.3600000000001,1,4,4,5,13,Champion
14622,1,320.58000000000004,185,1,2,1,4,Others
14623,5,889.25,32,4,3,4,11,Loyal
14624,2,225.85,57,3,1,3,7,SomeWhat Loyal
14625,2,899.63,196,3,3,1,7,SomeWhat Loyal
14626,4,2791.27,24,4,5,4,13,Champion
14628,2,671.96,91,3,3,2,8,SomeWhat Loyal
14629,2,959.01,4,3,4,5,12,Loyal
14631,3,1006.98,51,3,4,3,10,Loyal
14632,1,114.56,263,1,1,1,3,LOST
14633,1,344.90000000000003,266,1,2,1,4,Others
14636,2,609.85,36,3,3,3,9,Loyal
14638,1,443.6,51,1,2,3,6,SomeWhat Loyal
14639,6,2984.49,52,5,5,3,13,Champion
14640,6,2125.08,24,5,5,4,14,Champion
14641,1,110.46,22,1,1,4,6,SomeWhat Loyal
14642,1,96.12,59,1,1,3,5,SomeWhat Loyal
14643,2,693.8100000000001,170,3,3,2,8,SomeWhat Loyal
14644,2,830.76,68,3,3,3,9,Loyal
14645,2,597.09,157,3,3,2,8,SomeWhat Loyal
14646,73,280206.02,2,5,5,5,15,Champion
14647,1,243.22,201,1,1,1,3,LOST
14649,4,1417.29,5,4,4,5,13,Champion
14651,2,654.6,67,3,3,3,9,Loyal
14652,1,114.18,77,1,1,2,4,Others
14653,7,1947.55,1,5,4,5,14,Champion
14655,4,1932.23,8,4,4,5,13,Champion
14656,2,291.05,169,3,2,2,7,SomeWhat Loyal
14657,4,848.22,18,4,3,4,11,Loyal
14658,2,247.15,5,3,1,5,9,Loyal
14659,9,2529.93,9,5,5,5,15,Champion
14660,2,285.74,87,3,2,2,7,SomeWhat Loyal
14661,1,107.95,27,1,1,4,6,SomeWhat Loyal
14662,4,771.17,29,4,3,4,11,Loyal
14664,2,637.89,20,3,3,4,10,Loyal
14665,5,1835.7,61,4,4,3,11,Loyal
14666,1,195.25,24,1,1,4,6,SomeWhat Loyal
14667,25,9241.2,11,5,5,5,15,Champion
14669,3,1269.99,242,3,4,1,8,SomeWhat Loyal
14670,2,411.53,280,3,2,1,6,SomeWhat Loyal
14672,2,765.55,235,3,3,1,7,SomeWhat Loyal
14673,5,1736.4,3,4,4,5,13,Champion
14675,1,604.75,16,1,3,4,8,SomeWhat Loyal
14676,6,2548.2400000000002,31,5,5,4,14,Champion
14680,16,28754.11,25,5,5,4,14,Champion
14681,3,498.95,71,3,3,3,9,Loyal
14682,2,52.0,188,3,1,1,5,SomeWhat Loyal
14684,5,1236.28,26,4,4,4,12,Loyal
14687,1,628.38,107,1,3,2,6,SomeWhat Loyal
14688,21,5630.87,8,5,5,5,15,Champion
14689,1,112.8,209,1,1,1,3,LOST
14690,2,371.7,44,3,2,3,8,SomeWhat Loyal
14691,5,2114.33,31,4,5,4,13,Champion
14692,4,591.55,137,4,3,2,9,Loyal
14693,1,172.9,265,1,1,1,3,LOST
14696,7,2078.95,4,5,5,5,15,Champion
14697,2,188.60999999999999,218,3,1,1,5,SomeWhat Loyal
14698,5,1250.76,2,4,4,5,13,Champion
14699,1,109.13000000000001,214,1,1,1,3,LOST
14700,3,2235.3,32,3,5,4,12,Loyal
14701,9,2549.37,11,5,5,5,15,Champion
14702,17,3292.14,1,5,5,5,15,Champion
14703,1,318.17,15,1,2,4,7,SomeWhat Loyal
14704,9,1546.91,11,5,4,5,14,Champion
14705,1,179.0,199,1,1,1,3,LOST
14708,3,1126.37,3,3,4,5,12,Loyal
14709,13,4921.04,15,5,5,4,14,Champion
14710,4,606.13,14,4,3,4,11,Loyal
14711,11,2868.8,10,5,5,5,15,Champion
14712,3,917.07,29,3,3,4,10,Loyal
14713,11,2666.36,9,5,5,5,15,Champion
14714,1,160.19,24,1,1,4,6,SomeWhat Loyal
14715,4,867.38,25,4,3,4,11,Loyal
14716,2,329.68,43,3,2,3,8,SomeWhat Loyal
14719,5,1602.13,2,4,4,5,13,Champion
14720,3,663.81,6,3,3,5,11,Loyal
14722,1,187.92000000000002,147,1,1,2,4,Others
14723,6,1158.3,10,5,4,5,14,Champion
14725,1,718.08,25,1,3,4,8,SomeWhat Loyal
14727,1,268.58,274,1,2,1,4,Others
14729,1,313.49,374,1,2,1,4,Others
14730,8,2005.06,1,5,4,5,14,Champion
14731,3,380.02,47,3,2,3,8,SomeWhat Loyal
14732,8,2702.4900000000002,8,5,5,5,15,Champion
14733,12,9585.91,16,5,5,4,14,Champion
14735,32,6065.69,4,5,5,5,15,Champion
14737,3,1164.55,4,3,4,5,12,Loyal
14738,7,1314.45,43,5,4,3,12,Loyal
14739,7,3902.28,4,5,5,5,15,Champion
14740,3,1448.21,197,3,4,1,8,SomeWhat Loyal
14741,6,1400.34,12,5,4,5,14,Champion
14744,7,1099.98,16,5,4,4,13,Champion
14745,5,1220.26,113,4,4,2,10,Loyal
14747,1,328.2,249,1,2,1,4,Others
14748,5,1415.75,29,4,4,4,12,Loyal
14752,1,389.64,44,1,2,3,6,SomeWhat Loyal
14753,1,563.15,87,1,3,2,6,SomeWhat Loyal
14754,2,638.05,45,3,3,3,9,Loyal
14755,11,5010.28,10,5,5,5,15,Champion
14756,1,738.96,15,1,3,4,8,SomeWhat Loyal
14757,1,420.5,75,1,2,2,5,SomeWhat Loyal
14758,4,1484.06,145,4,4,2,10,Loyal
14759,3,1625.97,5,3,4,5,12,Loyal
14760,1,89.2,297,1,1,1,3,LOST
14761,2,255.9,59,3,2,3,8,SomeWhat Loyal
14762,1,300.52,264,1,2,1,4,Others
14764,1,278.3,47,1,2,3,6,SomeWhat Loyal
14765,3,254.11,29,3,2,4,9,Loyal
14766,6,2473.37,8,5,5,5,15,Champion
14768,2,192.60000000000002,17,3,1,4,8,SomeWhat Loyal
14769,8,10674.75,3,5,5,5,15,Champion
14770,2,876.42,232,3,3,1,7,SomeWhat Loyal
14772,1,139.26,112,1,1,2,4,Others
14775,3,1011.9,58,3,4,3,10,Loyal
14776,11,2538.3,51,5,5,3,13,Champion
14778,2,730.86,127,3,3,2,8,SomeWhat Loyal
14779,3,386.15,281,3,2,1,6,SomeWhat Loyal
14780,2,447.68,55,3,2,3,8,SomeWhat Loyal
14782,1,200.10000000000002,320,1,1,1,3,LOST
14784,2,289.99,26,3,2,4,9,Loyal
14785,2,77.4,10,3,1,5,9,Loyal
14788,2,679.4399999999999,7,3,3,5,11,Loyal
14789,1,197.64,29,1,1,4,6,SomeWhat Loyal
14790,4,745.06,17,4,3,4,11,Loyal
14792,1,6.2,64,1,1,3,5,SomeWhat Loyal
14793,1,228.99,21,1,1,4,6,SomeWhat Loyal
14794,7,1319.91,3,5,4,5,14,Champion
14795,1,131.45000000000002,166,1,1,2,4,Others
14796,17,8022.49,1,5,5,5,15,Champion
14798,3,173.74,53,3,1,3,7,SomeWhat Loyal
14799,1,157.7,51,1,1,3,5,SomeWhat Loyal
14800,12,4339.74,48,5,5,3,13,Champion
14801,1,193.14,61,1,1,3,5,SomeWhat Loyal
14803,3,845.55,162,3,3,2,8,SomeWhat Loyal
14804,1,353.27,9,1,2,5,8,SomeWhat Loyal
14805,4,554.65,15,4,3,4,11,Loyal
14806,1,193.39000000000001,75,1,1,2,4,Others
14808,8,2741.17,40,5,5,3,13,Champion
14810,11,2087.88,41,5,5,3,13,Champion
14813,2,155.43,370,3,1,1,5,SomeWhat Loyal
14815,2,778.5,37,3,3,3,9,Loyal
14816,1,271.85,197,1,2,1,4,Others
14817,2,1110.34,200,3,4,1,8,SomeWhat Loyal
14818,3,657.8,74,3,3,2,8,SomeWhat Loyal
14819,2,272.07,64,3,2,3,8,SomeWhat Loyal
14820,4,507.29,21,4,3,4,11,Loyal
14821,1,48.800000000000004,367,1,1,1,3,LOST
14823,3,321.43,180,3,2,1,6,SomeWhat Loyal
14824,4,1127.71,10,4,4,5,13,Champion
14825,12,2226.91,4,5,5,5,15,Champion
14828,3,2139.76,197,3,5,1,9,Loyal
14829,4,697.55,29,4,3,4,11,Loyal
14830,1,197.13,53,1,1,3,5,SomeWhat Loyal
14834,6,1720.3,18,5,4,4,13,Champion
14836,3,102.44999999999999,10,3,1,5,9,Loyal
14837,4,1649.5,90,4,4,2,10,Loyal
14840,1,62.85,268,1,1,1,3,LOST
14841,6,3295.76,53,5,5,3,13,Champion
14842,4,2824.69,44,4,5,3,12,Loyal
14844,4,3189.81,64,4,5,3,12,Loyal
14847,1,309.4,149,1,2,2,5,SomeWhat Loyal
14849,25,7930.54,22,5,5,4,14,Champion
14850,1,325.75,312,1,2,1,4,Others
14851,2,511.35,23,3,3,4,10,Loyal
14852,6,2836.69,58,5,5,3,13,Champion
14853,2,475.8,24,3,2,4,9,Loyal
14854,7,2759.83,78,5,5,2,12,Loyal
14855,2,645.65,119,3,3,2,8,SomeWhat Loyal
14856,3,1311.3799999999999,36,3,4,3,10,Loyal
14857,2,1173.12,60,3,4,3,10,Loyal
14859,4,1353.74,13,4,4,5,13,Champion
14860,1,170.32,19,1,1,4,6,SomeWhat Loyal
14861,1,125.79,52,1,1,3,5,SomeWhat Loyal
14862,2,841.1999999999999,26,3,3,4,10,Loyal
14863,1,266.76,29,1,2,4,7,SomeWhat Loyal
14865,2,52.2,7,3,1,5,9,Loyal
14866,12,14389.9,11,5,5,5,15,Champion
14867,3,710.28,186,3,3,1,7,SomeWhat Loyal
14868,8,2953.59,3,5,5,5,15,Champion
14869,2,725.7,9,3,3,5,11,Loyal
14870,1,327.25,262,1,2,1,4,Others
14871,4,522.38,3,4,3,5,12,Loyal
14873,1,519.68,210,1,3,1,5,SomeWhat Loyal
14875,2,1465.3200000000002,108,3,4,2,9,Loyal
14878,9,1485.54,13,5,4,5,14,Champion
14880,3,706.19,77,3,3,2,8,SomeWhat Loyal
14881,1,255.4,20,1,2,4,7,SomeWhat Loyal
14882,2,589.7,27,3,3,4,10,Loyal
14883,6,761.59,19,5,3,4,12,Loyal
14885,1,765.3199999999999,132,1,3,2,6,SomeWhat Loyal
14886,1,364.8,253,1,2,1,4,Others
14887,1,1862.0,79,1,4,2,7,SomeWhat Loyal
14888,1,369.2,207,1,2,1,4,Others
14889,1,135.9,336,1,1,1,3,LOST
14890,1,125.65,254,1,1,1,3,LOST
14891,2,554.38,148,3,3,2,8,SomeWhat Loyal
14893,2,1237.8500000000001,10,3,4,5,12,Loyal
14894,1,655.75,85,1,3,2,6,SomeWhat Loyal
14895,20,11138.710000000001,8,5,5,5,15,Champion
14896,2,468.77000000000004,205,3,2,1,6,SomeWhat Loyal
14897,4,1366.38,8,4,4,5,13,Champion
14898,6,1303.52,23,5,4,4,13,Champion
14901,9,1421.29,11,5,4,5,14,Champion
14902,1,332.66,26,1,2,4,7,SomeWhat Loyal
14903,5,2810.63,21,4,5,4,13,Champion
14904,2,1025.44,2,3,4,5,12,Loyal
14905,2,616.15,158,3,3,2,8,SomeWhat Loyal
14907,7,3501.1,3,5,5,5,15,Champion
14908,1,277.8,74,1,2,2,5,SomeWhat Loyal
14910,4,434.35,3,4,2,5,11,Loyal
14911,201,143825.06,1,5,5,5,15,Champion
14912,2,867.85,17,3,3,4,10,Loyal
14913,4,1227.43,36,4,4,3,11,Loyal
14915,2,307.48,91,3,2,2,7,SomeWhat Loyal
14916,4,1268.98,71,4,4,3,11,Loyal
14918,2,1610.15,116,3,4,2,9,Loyal
14920,2,977.77,213,3,4,1,8,SomeWhat Loyal
14921,2,1316.07,30,3,4,4,11,Loyal
14923,1,749.1,51,1,3,3,7,SomeWhat Loyal
14924,1,310.05,246,1,2,1,4,Others
14929,1,223.88,32,1,1,4,6,SomeWhat Loyal
14930,3,2372.86,109,3,5,2,10,Loyal
14931,5,1257.68,5,4,4,5,13,Champion
14932,1,363.53,366,1,2,1,4,Others
14934,2,1890.94,82,3,4,2,9,Loyal
14935,1,1784.71,297,1,4,1,6,SomeWhat Loyal
14936,8,8137.02,34,5,5,3,13,Champion
14937,3,1621.88,57,3,4,3,10,Loyal
14944,12,5900.25,30,5,5,4,14,Champion
14946,1,100.9,14,1,1,4,6,SomeWhat Loyal
14947,2,290.82,72,3,2,2,7,SomeWhat Loyal
14948,6,1101.97,23,5,4,4,13,Champion
14950,1,371.2,19,1,2,4,7,SomeWhat Loyal
14951,1,311.69,79,1,2,2,5,SomeWhat Loyal
14952,11,8099.49,60,5,5,3,13,Champion
14953,1,289.82,25,1,2,4,7,SomeWhat Loyal
14954,1,336.17,12,1,2,5,8,SomeWhat Loyal
14957,1,58.49,253,1,1,1,3,LOST
14958,3,499.68,147,3,3,2,8,SomeWhat Loyal
14959,4,695.42,64,4,3,3,10,Loyal
14960,2,221.27,8,3,1,5,9,Loyal
14961,9,7044.68,11,5,5,5,15,Champion
14962,1,126.7,271,1,1,1,3,LOST
14963,5,1487.8,10,4,4,5,13,Champion
14964,1,206.21,247,1,1,1,3,LOST
14965,2,599.0,96,3,3,2,8,SomeWhat Loyal
14966,1,191.32,15,1,1,4,6,SomeWhat Loyal
14967,1,463.8,50,1,2,3,6,SomeWhat Loyal
14968,1,147.59,30,1,1,4,6,SomeWhat Loyal
14970,4,1592.06,68,4,4,3,11,Loyal
14971,3,1116.57,35,3,4,3,10,Loyal
14972,1,114.77,128,1,1,2,4,Others
14973,3,1314.45,107,3,4,2,9,Loyal
14974,1,114.39,37,1,1,3,5,SomeWhat Loyal
14975,1,279.94,57,1,2,3,6,SomeWhat Loyal
14976,7,790.86,57,5,3,3,11,Loyal
14978,5,1931.42,72,4,4,2,10,Loyal
14981,1,102.12,246,1,1,1,3,LOST
14984,2,213.27,19,3,1,4,8,SomeWhat Loyal
14985,2,296.75,198,3,2,1,6,SomeWhat Loyal
14987,2,326.4,16,3,2,4,9,Loyal
14988,1,334.54,212,1,2,1,4,Others
14995,2,233.23000000000002,39,3,1,3,7,SomeWhat Loyal
14997,3,546.1999999999999,46,3,3,3,9,Loyal
14998,2,429.87,170,3,2,2,7,SomeWhat Loyal
15000,1,490.52,48,1,3,3,7,SomeWhat Loyal
15002,4,1641.76,116,4,4,2,10,Loyal
15004,1,1246.32,147,1,4,2,7,SomeWhat Loyal
15005,28,6316.57,16,5,5,4,14,Champion
15006,1,502.09,51,1,3,3,7,SomeWhat Loyal
15007,1,156.91,159,1,1,2,4,Others
15009,3,1261.78,12,3,4,5,12,Loyal
15010,1,308.94,36,1,2,3,6,SomeWhat Loyal
15012,2,423.04,54,3,2,3,8,SomeWhat Loyal
15014,2,260.17,43,3,2,3,8,SomeWhat Loyal
15016,1,170.04,173,1,1,2,4,Others
15017,1,125.58,34,1,1,3,5,SomeWhat Loyal
15018,3,496.21000000000004,39,3,3,3,9,Loyal
15019,1,266.0,267,1,2,1,4,Others
15021,9,1914.82,9,5,4,5,14,Champion
15022,4,905.04,12,4,3,5,12,Loyal
15023,11,6802.76,3,5,5,5,15,Champion
15024,10,1661.33,10,5,4,5,14,Champion
15025,1,377.01,33,1,2,3,6,SomeWhat Loyal
15026,3,469.0,80,3,2,2,7,SomeWhat Loyal
15027,4,1066.1499999999999,31,4,4,4,12,Loyal
15028,4,627.13,8,4,3,5,12,Loyal
15030,2,518.28,72,3,3,2,8,SomeWhat Loyal
15031,4,668.14,4,4,3,5,12,Loyal
15032,3,4959.1,256,3,5,1,9,Loyal
15033,10,2586.67,5,5,5,5,15,Champion
15034,8,4308.61,16,5,5,4,14,Champion
15035,1,252.73000000000002,90,1,2,2,5,SomeWhat Loyal
15036,3,465.55,72,3,2,2,7,SomeWhat Loyal
15038,6,705.49,59,5,3,3,11,Loyal
15039,47,19914.44,10,5,5,5,15,Champion
15041,1,180.35,170,1,1,2,4,Others
15042,1,135.93,199,1,1,1,3,LOST
15043,1,537.0,31,1,3,4,8,SomeWhat Loyal
15044,17,7700.2300000000005,19,5,5,4,14,Champion
15045,2,735.66,152,3,3,2,8,SomeWhat Loyal
15046,15,5213.7699999999995,9,5,5,5,15,Champion
15047,1,343.62,270,1,2,1,4,Others
15048,4,384.05,65,4,2,3,9,Loyal
15049,1,121.17000000000002,274,1,1,1,3,LOST
15050,3,1782.09,25,3,4,4,11,Loyal
15051,3,1391.61,23,3,4,4,11,Loyal
15052,1,215.78,319,1,1,1,3,LOST
15053,3,697.79,5,3,3,5,11,Loyal
15054,2,302.1,12,3,2,5,10,Loyal
15057,2,1489.5,275,3,4,1,8,SomeWhat Loyal
15058,11,2124.9900000000002,25,5,5,4,14,Champion
15059,9,1337.72,41,5,4,3,12,Loyal
15060,4,303.09,8,4,2,5,11,Loyal
15061,48,54534.14,4,5,5,5,15,Champion
15062,4,987.86,71,4,4,3,11,Loyal
15063,1,370.79999999999995,213,1,2,1,4,Others
15065,4,3158.13,38,4,5,3,12,Loyal
15066,1,893.59,53,1,3,3,7,SomeWhat Loyal
15067,3,1744.76,78,3,4,2,9,Loyal
15068,2,553.36,46,3,3,3,9,Loyal
15069,1,1109.53,179,1,4,1,6,SomeWhat Loyal
15070,1,106.2,373,1,1,1,3,LOST
15071,2,982.07,94,3,4,2,9,Loyal
15073,3,1043.41,10,3,4,5,12,Loyal
15074,1,748.87,105,1,3,2,6,SomeWhat Loyal
15075,1,773.03,78,1,3,2,6,SomeWhat Loyal
15076,1,880.85,173,1,3,2,6,SomeWhat Loyal
15078,32,9743.11,7,5,5,5,15,Champion
15079,4,895.61,213,4,3,1,8,SomeWhat Loyal
15081,5,504.8,22,4,3,4,11,Loyal
15083,1,88.2,257,1,1,1,3,LOST
15087,1,306.94,282,1,2,1,4,Others
15088,2,1160.07,21,3,4,4,11,Loyal
15089,6,2420.84,10,5,5,5,15,Champion
15090,1,381.32,308,1,2,1,4,Others
15091,1,480.71,68,1,2,3,6,SomeWhat Loyal
15092,2,457.81,215,3,2,1,6,SomeWhat Loyal
15093,6,4597.02,18,5,5,4,14,Champion
15095,4,1370.6,104,4,4,2,10,Loyal
15096,1,219.39000000000001,43,1,1,3,5,SomeWhat Loyal
15097,1,248.08,4,1,1,5,7,SomeWhat Loyal
15098,3,39916.5,182,3,5,1,9,Loyal
15099,1,410.48,84,1,2,2,5,SomeWhat Loyal
15100,3,876.0,334,3,3,1,7,SomeWhat Loyal
15101,2,317.53,9,3,2,5,10,Loyal
15103,2,703.36,31,3,3,4,10,Loyal
15104,2,1027.44,197,3,4,1,8,SomeWhat Loyal
15105,7,2298.93,18,5,5,4,14,Champion
15106,5,1422.52,18,4,4,4,12,Loyal
15107,6,319.5,311,5,2,1,8,SomeWhat Loyal
15108,4,1300.25,142,4,4,2,10,Loyal
15109,1,484.95,246,1,2,1,4,Others
15110,4,996.1,24,4,4,4,12,Loyal
15111,3,1567.48,29,3,4,4,11,Loyal
15113,3,3609.33,10,3,5,5,13,Champion
15114,10,2760.56,30,5,5,4,14,Champion
15115,1,340.11,18,1,2,4,7,SomeWhat Loyal
15116,4,1352.75,18,4,4,4,12,Loyal
15117,5,1551.78,15,4,4,4,12,Loyal
15118,1,244.8,134,1,1,2,4,Others
15119,1,266.4,246,1,2,1,4,Others
15120,1,358.82,134,1,2,2,5,SomeWhat Loyal
15121,2,457.72,50,3,2,3,8,SomeWhat Loyal
15122,3,1633.78,114,3,4,2,9,Loyal
15123,2,2199.31,7,3,5,5,13,Champion
15124,2,184.19,23,3,1,4,8,SomeWhat Loyal
15125,15,11528.48,25,5,5,4,14,Champion
15127,1,406.53,66,1,2,3,6,SomeWhat Loyal
15128,4,1471.0,60,4,4,3,11,Loyal
15129,11,3447.4,50,5,5,3,13,Champion
15130,1,330.11,170,1,2,2,5,SomeWhat Loyal
15132,5,977.9300000000001,18,4,4,4,12,Loyal
15133,3,982.42,128,3,4,2,9,Loyal
15134,8,1387.99,15,5,4,4,13,Champion
15135,1,139.05,239,1,1,1,3,LOST
15136,4,1286.7,3,4,4,5,13,Champion
15139,2,178.96,240,3,1,1,5,SomeWhat Loyal
15140,7,2354.25,52,5,5,3,13,Champion
15142,1,498.74,46,1,3,3,7,SomeWhat Loyal
15143,1,259.45,226,1,2,1,4,Others
15144,17,6580.44,8,5,5,5,15,Champion
15145,4,1194.73,4,4,4,5,13,Champion
15146,2,1327.16,165,3,4,2,9,Loyal
15147,1,623.5,240,1,3,1,5,SomeWhat Loyal
15148,1,301.29,11,1,2,5,8,SomeWhat Loyal
15149,1,520.8000000000001,134,1,3,2,6,SomeWhat Loyal
15150,10,5314.47,17,5,5,4,14,Champion
15152,13,4745.69,10,5,5,5,15,Champion
15153,1,329.25,31,1,2,4,7,SomeWhat Loyal
15154,1,296.42,75,1,2,2,5,SomeWhat Loyal
15156,3,961.49,1,3,4,5,12,Loyal
15157,3,1936.07,4,3,4,5,12,Loyal
15158,1,401.40000000000003,45,1,2,3,6,SomeWhat Loyal
15159,30,18641.010000000002,2,5,5,5,15,Champion
15160,1,158.16,357,1,1,1,3,LOST
15163,2,304.47,18,3,2,4,9,Loyal
15164,3,843.05,69,3,3,3,9,Loyal
15165,1,487.75,373,1,2,1,4,Others
15167,1,163.0,321,1,1,1,3,LOST
15168,1,106.56,26,1,1,4,6,SomeWhat Loyal
15171,1,1289.5,331,1,4,1,6,SomeWhat Loyal
15172,5,1624.05,9,4,4,5,13,Champion
15174,1,135.75,323,1,1,1,3,LOST
15175,1,224.14,72,1,1,2,4,Others
15178,1,40.5,260,1,1,1,3,LOST
15179,5,2206.95,18,4,5,4,13,Champion
15180,1,87.5,367,1,1,1,3,LOST
15181,3,689.4799999999999,66,3,3,3,9,Loyal
15182,2,622.85,154,3,3,2,8,SomeWhat Loyal
15184,2,406.76,29,3,2,4,9,Loyal
15185,1,310.62,70,1,2,3,6,SomeWhat Loyal
15186,2,411.41,14,3,2,4,9,Loyal
15187,16,4777.18,2,5,5,5,15,Champion
15189,41,16225.39,1,5,5,5,15,Champion
15192,3,1044.32,120,3,4,2,9,Loyal
15193,1,499.32,61,1,3,3,7,SomeWhat Loyal
15194,15,7616.53,3,5,5,5,15,Champion
15195,1,3861.0,3,1,5,5,11,Loyal
15197,3,1079.6100000000001,11,3,4,5,12,Loyal
15198,2,193.64,92,3,1,2,6,SomeWhat Loyal
15199,4,1268.7,59,4,4,3,11,Loyal
15201,5,1236.54,87,4,4,2,10,Loyal
15203,6,1827.8,26,5,4,4,13,Champion
15204,1,316.58,357,1,2,1,4,Others
15205,2,653.24,85,3,3,2,8,SomeWhat Loyal
15206,4,420.29999999999995,10,4,2,5,11,Loyal
15208,5,870.12,1,4,3,5,12,Loyal
15210,1,331.18,225,1,2,1,4,Others
15211,2,894.4100000000001,60,3,3,3,9,Loyal
15212,1,101.8,241,1,1,1,3,LOST
15213,2,328.35,319,3,2,1,6,SomeWhat Loyal
15214,8,1661.44,2,5,4,5,14,Champion
15215,3,734.94,47,3,3,3,9,Loyal
15216,1,96.6,88,1,1,2,4,Others
15218,11,5756.89,11,5,5,5,15,Champion
15219,1,305.75,176,1,2,2,5,SomeWhat Loyal
15220,6,1778.96,52,5,4,3,12,Loyal
15221,1,403.25,366,1,2,1,4,Others
15222,1,585.0,319,1,3,1,5,SomeWhat Loyal
15223,2,755.75,226,3,3,1,7,SomeWhat Loyal
15224,2,322.08,358,3,2,1,6,SomeWhat Loyal
15225,1,409.40000000000003,234,1,2,1,4,Others
15226,1,154.41,311,1,1,1,3,LOST
15227,5,1219.4,37,4,4,3,11,Loyal
15228,4,3386.71,66,4,5,3,12,Loyal
15230,2,429.6,239,3,2,1,6,SomeWhat Loyal
15232,2,612.06,113,3,3,2,8,SomeWhat Loyal
15234,1,197.0,277,1,1,1,3,LOST
15235,12,2247.51,218,5,5,1,11,Loyal
15236,1,321.05,299,1,2,1,4,Others
15237,4,1412.32,2,4,4,5,13,Champion
15238,3,1071.99,29,3,4,4,11,Loyal
15239,2,780.59,10,3,3,5,11,Loyal
15240,5,1706.57,45,4,4,3,11,Loyal
15241,8,1756.44,67,5,4,3,12,Loyal
15243,1,316.68,74,1,2,2,5,SomeWhat Loyal
15244,2,631.57,65,3,3,3,9,Loyal
15245,3,2515.84,134,3,5,2,10,Loyal
15246,2,514.15,238,3,3,1,7,SomeWhat Loyal
15247,1,356.0,122,1,2,2,5,SomeWhat Loyal
15249,13,6688.46,32,5,5,4,14,Champion
15251,11,10484.99,9,5,5,5,15,Champion
15252,2,740.78,36,3,3,3,9,Loyal
15253,5,918.1999999999999,16,4,3,4,11,Loyal
15254,1,300.36,127,1,2,2,5,SomeWhat Loyal
15255,1,890.85,67,1,3,3,7,SomeWhat Loyal
15256,1,98.45,149,1,1,2,4,Others
15257,1,317.15,283,1,2,1,4,Others
15258,2,623.16,169,3,3,2,8,SomeWhat Loyal
15260,7,1810.77,100,5,4,2,11,Loyal
15261,1,254.82,135,1,2,2,5,SomeWhat Loyal
15262,1,178.95000000000002,324,1,1,1,3,LOST
15263,1,156.51,107,1,1,2,4,Others
15264,1,393.74,64,1,2,3,6,SomeWhat Loyal
15265,2,1506.1200000000001,151,3,4,2,9,Loyal
15266,1,119.3,338,1,1,1,3,LOST
15267,5,1717.36,22,4,4,4,12,Loyal
15269,1,408.8,24,1,2,4,7,SomeWhat Loyal
15270,7,2379.49,16,5,5,4,14,Champion
15271,15,2507.07,7,5,5,5,15,Champion
15272,2,721.94,57,3,3,3,9,Loyal
15274,2,716.57,4,3,3,5,11,Loyal
15275,1,615.14,38,1,3,3,7,SomeWhat Loyal
15276,1,135.31,66,1,1,3,5,SomeWhat Loyal
15277,1,255.89999999999998,47,1,2,3,6,SomeWhat Loyal
15279,1,290.51,355,1,2,1,4,Others
15280,1,113.12,172,1,1,2,4,Others
15281,9,2332.15,59,5,5,3,13,Champion
15286,1,240.55,50,1,1,3,5,SomeWhat Loyal
15287,2,486.69,22,3,2,4,9,Loyal
15288,5,2306.52,43,4,5,3,12,Loyal
15289,3,939.78,29,3,3,4,10,Loyal
15290,18,7943.22,5,5,5,5,15,Champion
15291,15,4668.3,26,5,5,4,14,Champion
15292,1,180.94,201,1,1,1,3,LOST
15296,6,3672.86,51,5,5,3,13,Champion
15297,3,641.94,10,3,3,5,11,Loyal
15298,12,4799.9,2,5,5,5,15,Champion
15299,7,4507.01,67,5,5,3,13,Champion
15300,1,496.44,64,1,3,3,7,SomeWhat Loyal
15301,12,5070.35,51,5,5,3,13,Champion
15303,1,574.02,290,1,3,1,5,SomeWhat Loyal
15304,8,694.4000000000001,61,5,3,3,11,Loyal
15306,3,1174.35,64,3,4,3,10,Loyal
15307,1,205.3,96,1,1,2,4,Others
15308,1,310.47,274,1,2,1,4,Others
15311,91,60767.9,1,5,5,5,15,Champion
15312,4,924.85,75,4,3,2,9,Loyal
15313,1,52.0,110,1,1,2,4,Others
15314,1,327.97,199,1,2,1,4,Others
15315,2,570.5,64,3,3,3,9,Loyal
15316,1,165.0,327,1,1,1,3,LOST
15318,1,312.62,4,1,2,5,8,SomeWhat Loyal
15319,1,204.5,284,1,1,1,3,LOST
15320,1,267.13,44,1,2,3,6,SomeWhat Loyal
15321,3,2748.31,71,3,5,3,11,Loyal
15322,1,679.68,86,1,3,2,6,SomeWhat Loyal
15325,1,162.29,104,1,1,2,4,Others
15326,1,311.71,334,1,2,1,4,Others
15327,1,208.75,53,1,1,3,5,SomeWhat Loyal
15329,3,1049.7,39,3,4,3,10,Loyal
15330,2,714.96,32,3,3,4,10,Loyal
15332,4,1661.06,366,4,4,1,9,Loyal
15333,1,1028.56,208,1,4,1,6,SomeWhat Loyal
15334,3,351.67,157,3,2,2,7,SomeWhat Loyal
15335,1,173.97,54,1,1,3,5,SomeWhat Loyal
15339,2,574.07,66,3,3,3,9,Loyal
15341,1,2020.52,81,1,4,2,7,SomeWhat Loyal
15342,1,406.09,130,1,2,2,5,SomeWhat Loyal
15343,1,364.5,87,1,2,2,5,SomeWhat Loyal
15344,3,563.94,1,3,3,5,11,Loyal
15345,1,393.54,46,1,2,3,6,SomeWhat Loyal
15346,1,252.42000000000002,333,1,2,1,4,Others
15347,1,201.60000000000002,366,1,1,1,3,LOST
15348,1,158.04,72,1,1,2,4,Others
15349,2,473.81,158,3,2,2,7,SomeWhat Loyal
15350,1,115.65,373,1,1,1,3,LOST
15351,7,1960.1100000000001,12,5,4,5,14,Champion
15353,2,777.02,255,3,3,1,7,SomeWhat Loyal
15355,2,277.05,29,3,2,4,9,Loyal
15356,10,2766.5,31,5,5,4,14,Champion
15358,22,8347.2,5,5,5,5,15,Champion
15360,1,427.93,40,1,2,3,6,SomeWhat Loyal
15361,1,418.92,362,1,2,1,4,Others
15363,1,326.0,373,1,2,1,4,Others
15364,2,913.19,96,3,3,2,8,SomeWhat Loyal
15365,7,2314.32,26,5,5,4,14,Champion
15366,2,602.51,75,3,3,2,8,SomeWhat Loyal
15367,4,1877.59,57,4,4,3,11,Loyal
15368,1,446.94000000000005,21,1,2,4,7,SomeWhat Loyal
15370,7,2386.05,41,5,5,3,13,Champion
15372,1,2007.3999999999999,137,1,4,2,7,SomeWhat Loyal
15373,12,2415.91,8,5,5,5,15,Champion
15374,1,168.0,129,1,1,2,4,Others
15376,3,1233.3600000000001,40,3,4,3,10,Loyal
15379,7,3703.29,169,5,5,2,12,Loyal
15380,5,1690.2600000000002,9,4,4,5,13,Champion
15381,2,596.85,214,3,3,1,7,SomeWhat Loyal
15382,6,5955.71,15,5,5,4,14,Champion
15384,2,642.41,170,3,3,2,8,SomeWhat Loyal
15385,1,316.88,40,1,2,3,6,SomeWhat Loyal
15386,1,394.14,186,1,2,1,4,Others
15388,1,140.54,270,1,1,1,3,LOST
15389,1,500.0,172,1,3,2,6,SomeWhat Loyal
15392,4,1535.53,5,4,4,5,13,Champion
15393,2,231.86,16,3,1,4,8,SomeWhat Loyal
15394,4,2183.54,10,4,5,5,14,Champion
15395,1,107.45,326,1,1,1,3,LOST
15396,1,288.18,113,1,2,2,5,SomeWhat Loyal
15397,1,94.0,290,1,1,1,3,LOST
15398,2,1345.53,16,3,4,4,11,Loyal
15399,3,815.77,1,3,3,5,11,Loyal
15400,5,716.2,92,4,3,2,9,Loyal
15402,2,626.77,149,3,3,2,8,SomeWhat Loyal
15405,1,349.1,189,1,2,1,4,Others
15406,2,510.71000000000004,31,3,3,4,10,Loyal
15407,4,1056.44,34,4,4,3,11,Loyal
15408,1,267.18,264,1,2,1,4,Others
15410,8,3450.84,84,5,5,2,12,Loyal
15411,4,1358.88,26,4,4,4,12,Loyal
15412,1,190.53,171,1,1,2,4,Others
15414,3,774.9000000000001,10,3,3,5,11,Loyal
15415,1,572.8100000000001,313,1,3,1,5,SomeWhat Loyal
15416,4,3984.32,65,4,5,3,12,Loyal
15417,1,508.8,85,1,3,2,6,SomeWhat Loyal
15419,1,135.86,25,1,1,4,6,SomeWhat Loyal
15421,4,950.36,59,4,4,3,11,Loyal
15422,2,97.7,323,3,1,1,5,SomeWhat Loyal
15423,1,43.5,38,1,1,3,5,SomeWhat Loyal
15424,2,383.34,254,3,2,1,6,SomeWhat Loyal
15426,5,1447.39,19,4,4,4,12,Loyal
15427,3,1483.14,33,3,4,3,10,Loyal
15428,1,93.78,15,1,1,4,6,SomeWhat Loyal
15429,2,397.35,27,3,2,4,9,Loyal
15432,1,171.19,23,1,1,4,6,SomeWhat Loyal
15433,2,533.3,214,3,3,1,7,SomeWhat Loyal
15434,5,1041.48,8,4,4,5,13,Champion
15435,1,149.29,22,1,1,4,6,SomeWhat Loyal
15436,3,1122.53,12,3,4,5,12,Loyal
15437,1,200.16,262,1,1,1,3,LOST
15438,1,156.57999999999998,131,1,1,2,4,Others
15440,3,383.68,55,3,2,3,8,SomeWhat Loyal
15442,1,594.0,249,1,3,1,5,SomeWhat Loyal
15443,7,3236.91,2,5,5,5,15,Champion
15444,2,1418.26,9,3,4,5,12,Loyal
15445,1,113.5,264,1,1,1,3,LOST
15447,1,155.17,331,1,1,1,3,LOST
15448,1,494.64,313,1,3,1,5,SomeWhat Loyal
15449,3,974.52,26,3,4,4,11,Loyal
15450,1,429.84,30,1,2,4,7,SomeWhat Loyal
15452,3,538.73,30,3,3,4,10,Loyal
15453,7,1388.37,2,5,4,5,14,Champion
15454,1,179.1,362,1,1,1,3,LOST
15456,3,447.22,283,3,2,1,6,SomeWhat Loyal
15457,1,237.07,262,1,1,1,3,LOST
15458,1,161.64,25,1,1,4,6,SomeWhat Loyal
15460,1,216.76,354,1,1,1,3,LOST
15462,3,234.6,94,3,1,2,6,SomeWhat Loyal
15463,1,126.14,29,1,1,4,6,SomeWhat Loyal
15464,1,1048.85,338,1,4,1,6,SomeWhat Loyal
15465,18,7354.62,20,5,5,4,14,Champion
15466,1,334.53,85,1,2,2,5,SomeWhat Loyal
15467,3,524.88,9,3,3,5,11,Loyal
15468,2,467.51,51,3,2,3,8,SomeWhat Loyal
15469,2,538.55,50,3,3,3,9,Loyal
15471,1,469.48,2,1,2,5,8,SomeWhat Loyal
15472,1,371.56,113,1,2,2,5,SomeWhat Loyal
15473,7,1771.2,14,5,4,4,13,Champion
15475,1,454.10999999999996,77,1,2,2,5,SomeWhat Loyal
15478,2,1441.42,40,3,4,3,10,Loyal
15480,1,905.5,116,1,3,2,6,SomeWhat Loyal
15482,12,11054.96,16,5,5,4,14,Champion
15483,4,233.81,161,4,1,2,7,SomeWhat Loyal
15484,4,3594.31,1,4,5,5,14,Champion
15485,3,2575.0,30,3,5,4,12,Loyal
15488,1,91.32000000000001,93,1,1,2,4,Others
15489,3,1134.28,23,3,4,4,11,Loyal
15491,6,3100.09,95,5,5,2,12,Loyal
15492,2,659.4599999999999,28,3,3,4,10,Loyal
15493,5,2001.8,33,4,4,3,11,Loyal
15494,2,1299.23,21,3,4,4,11,Loyal
15497,2,1262.2,18,3,4,4,11,Loyal
15498,27,13316.4,3,5,5,5,15,Champion
15500,4,1131.56,8,4,4,5,13,Champion
15502,12,10384.93,16,5,5,4,14,Champion
15503,1,147.09,363,1,1,1,3,LOST
15504,1,52.83,81,1,1,2,4,Others
15505,5,3610.96,53,4,5,3,12,Loyal
15506,3,979.26,23,3,4,4,11,Loyal
15507,1,492.36,172,1,3,2,6,SomeWhat Loyal
15508,6,1000.27,189,5,4,1,10,Loyal
15510,1,250.0,331,1,1,1,3,LOST
15511,5,909.23,12,4,3,5,12,Loyal
15512,2,121.0,156,3,1,2,6,SomeWhat Loyal
15513,19,14758.220000000001,33,5,5,3,13,Champion
15514,11,4139.46,12,5,5,5,15,Champion
15516,3,62.43,45,3,1,3,7,SomeWhat Loyal
15517,1,267.03,233,1,2,1,4,Others
15518,8,1942.45,64,5,4,3,12,Loyal
15520,1,343.5,2,1,2,5,8,SomeWhat Loyal
15521,8,3000.2,40,5,5,3,13,Champion
15522,2,398.84,33,3,2,3,8,SomeWhat Loyal
15523,1,412.01000000000005,84,1,2,2,5,SomeWhat Loyal
15524,1,440.0,25,1,2,4,7,SomeWhat Loyal
15525,3,825.92,2,3,3,5,11,Loyal
15526,2,148.44,33,3,1,3,7,SomeWhat Loyal
15527,8,2429.78,19,5,5,4,14,Champion
15528,1,229.33,254,1,1,1,3,LOST
15529,11,3995.23,23,5,5,4,14,Champion
15530,4,1502.35,22,4,4,4,12,Loyal
15531,2,2007.44,8,3,4,5,12,Loyal
15532,4,1580.93,25,4,4,4,12,Loyal
15533,3,807.57,19,3,3,4,10,Loyal
15535,4,536.4,173,4,3,2,9,Loyal
15537,1,110.92,163,1,1,2,4,Others
15539,1,538.46,7,1,3,5,9,Loyal
15540,1,213.3,11,1,1,5,7,SomeWhat Loyal
15541,1,85.13000000000001,114,1,1,2,4,Others
15543,1,127.86,288,1,1,1,3,LOST
15544,9,3546.71,9,5,5,5,15,Champion
15545,2,292.71999999999997,54,3,2,3,8,SomeWhat Loyal
15547,14,4954.84,7,5,5,5,15,Champion
15549,3,1693.26,77,3,4,2,9,Loyal
15550,4,575.63,4,4,3,5,12,Loyal
15551,1,436.06,37,1,2,3,6,SomeWhat Loyal
15552,1,90.12,217,1,1,1,3,LOST
15553,1,437.23,60,1,2,3,6,SomeWhat Loyal
15554,1,217.2,278,1,1,1,3,LOST
15555,16,4805.17,12,5,5,5,15,Champion
15556,1,279.77,24,1,2,4,7,SomeWhat Loyal
15557,1,473.65000000000003,29,1,2,4,7,SomeWhat Loyal
15561,4,800.59,12,4,3,5,12,Loyal
15562,1,134.55,352,1,1,1,3,LOST
15563,4,1400.44,22,4,4,4,12,Loyal
15565,2,173.16,50,3,1,3,7,SomeWhat Loyal
15567,1,186.01,19,1,1,4,6,SomeWhat Loyal
15568,3,758.29,3,3,3,5,11,Loyal
15569,5,1375.71,104,4,4,2,10,Loyal
15570,12,4165.52,7,5,5,5,15,Champion
15571,4,650.4300000000001,12,4,3,5,12,Loyal
15572,7,2552.86,5,5,5,5,15,Champion
15573,2,607.45,32,3,3,4,10,Loyal
15574,4,702.25,178,4,3,2,9,Loyal
15576,1,940.6700000000001,38,1,3,3,7,SomeWhat Loyal
15577,3,258.88,151,3,2,2,7,SomeWhat Loyal
15578,1,127.1,162,1,1,2,4,Others
15579,2,348.6,69,3,2,3,8,SomeWhat Loyal
15581,13,3679.9700000000003,121,5,5,2,12,Loyal
15582,3,682.9100000000001,25,3,3,4,10,Loyal
15584,4,725.11,24,4,3,4,11,Loyal
15585,1,455.3,177,1,2,2,5,SomeWhat Loyal
15587,4,913.6800000000001,50,4,3,3,10,Loyal
15589,3,478.53000000000003,256,3,2,1,6,SomeWhat Loyal
15592,1,388.58,47,1,2,3,6,SomeWhat Loyal
15593,1,199.8,71,1,1,3,5,SomeWhat Loyal
15594,5,1771.78,16,4,4,4,12,Loyal
15596,5,1406.59,101,4,4,2,10,Loyal
15597,1,324.57,35,1,2,3,6,SomeWhat Loyal
15598,1,240.68,53,1,1,3,5,SomeWhat Loyal
15599,2,761.74,27,3,3,4,10,Loyal
15601,14,6776.56,11,5,5,5,15,Champion
15602,9,1297.8700000000001,8,5,4,5,14,Champion
15603,1,48.480000000000004,79,1,1,2,4,Others
15604,1,216.39,52,1,1,3,5,SomeWhat Loyal
15605,5,1198.23,36,4,4,3,11,Loyal
15606,9,2920.16,61,5,5,3,13,Champion
15607,1,104.76,337,1,1,1,3,LOST
15608,4,1093.68,28,4,4,4,12,Loyal
15609,1,298.48,184,1,2,1,4,Others
15610,1,112.46000000000001,52,1,1,3,5,SomeWhat Loyal
15611,13,1591.45,10,5,4,5,14,Champion
15612,2,195.15,36,3,1,3,7,SomeWhat Loyal
15615,23,10399.74,10,5,5,5,15,Champion
15618,4,776.851,33,4,3,3,10,Loyal
15619,1,336.40000000000003,11,1,2,5,8,SomeWhat Loyal
15620,3,1553.18,57,3,4,3,10,Loyal
15621,4,1293.03,4,4,4,5,13,Champion
15622,9,3709.56,43,5,5,3,13,Champion
15623,1,301.03,141,1,2,2,5,SomeWhat Loyal
15624,4,588.13,117,4,3,2,9,Loyal
15625,4,1534.26,104,4,4,2,10,Loyal
15626,2,675.8,75,3,3,2,8,SomeWhat Loyal
15628,9,2870.2400000000002,5,5,5,5,15,Champion
15630,2,1186.35,45,3,4,3,10,Loyal
15632,8,3285.31,16,5,5,4,14,Champion
15634,1,243.55,17,1,1,4,6,SomeWhat Loyal
15636,2,724.76,90,3,3,2,8,SomeWhat Loyal
15637,1,223.36,53,1,1,3,5,SomeWhat Loyal
15639,1,425.32,134,1,2,2,5,SomeWhat Loyal
15640,15,12515.66,4,5,5,5,15,Champion
15641,4,1887.2,105,4,4,2,10,Loyal
15643,3,664.0,192,3,3,1,7,SomeWhat Loyal
15644,4,813.0,166,4,3,2,9,Loyal
15645,1,612.01,19,1,3,4,8,SomeWhat Loyal
15646,3,447.64000000000004,158,3,2,2,7,SomeWhat Loyal
15648,2,657.35,204,3,3,1,7,SomeWhat Loyal
15649,2,816.0,336,3,3,1,7,SomeWhat Loyal
15651,3,646.3,37,3,3,3,9,Loyal
15652,1,337.74,91,1,2,2,5,SomeWhat Loyal
15653,2,877.4399999999999,93,3,3,2,8,SomeWhat Loyal
15654,2,922.53,9,3,3,5,11,Loyal
15655,1,560.67,243,1,3,1,5,SomeWhat Loyal
15656,4,748.5,45,4,3,3,10,Loyal
15657,1,30.0,23,1,1,4,6,SomeWhat Loyal
15658,5,1024.1000000000001,190,4,4,1,9,Loyal
15659,1,306.45,44,1,2,3,6,SomeWhat Loyal
15660,9,1600.86,25,5,4,4,13,Champion
15661,2,309.8,317,3,2,1,6,SomeWhat Loyal
15663,1,138.14,106,1,1,2,4,Others
15664,1,386.43,51,1,2,3,6,SomeWhat Loyal
15665,2,2242.01,168,3,5,2,10,Loyal
15667,1,301.32,40,1,2,3,6,SomeWhat Loyal
15668,1,76.32000000000001,218,1,1,1,3,LOST
15669,4,684.34,40,4,3,3,10,Loyal
15670,1,173.05,297,1,1,1,3,LOST
15671,7,2657.13,19,5,5,4,14,Champion
15673,4,2881.02,88,4,5,2,11,Loyal
15674,5,2446.6,73,4,5,2,11,Loyal
15675,3,323.69,81,3,2,2,7,SomeWhat Loyal
15676,3,3435.76,19,3,5,4,12,Loyal
15677,1,657.23,49,1,3,3,7,SomeWhat Loyal
15678,1,352.7,53,1,2,3,6,SomeWhat Loyal
15679,4,781.28,24,4,3,4,11,Loyal
15680,3,1333.68,9,3,4,5,12,Loyal
15681,5,1426.16,25,4,4,4,12,Loyal
15683,1,193.75,117,1,1,2,4,Others
15687,9,2993.1,9,5,5,5,15,Champion
15689,2,254.1,120,3,2,2,7,SomeWhat Loyal
15690,2,239.76,4,3,1,5,9,Loyal
15691,1,136.8,252,1,1,1,3,LOST
15692,1,191.04,28,1,1,4,6,SomeWhat Loyal
15694,14,6479.4,1,5,5,5,15,Champion
15695,2,409.98,267,3,2,1,6,SomeWhat Loyal
15696,8,2736.46,33,5,5,3,13,Champion
15699,1,309.65,18,1,2,4,7,SomeWhat Loyal
15700,2,696.68,172,3,3,2,8,SomeWhat Loyal
15701,4,1542.14,2,4,4,5,13,Champion
15703,1,211.5,265,1,1,1,3,LOST
15704,4,2293.62,140,4,5,2,11,Loyal
15705,1,143.1,201,1,1,1,3,LOST
15706,4,1060.56,64,4,4,3,11,Loyal
15707,4,945.58,35,4,4,3,11,Loyal
15708,7,3364.2400000000002,41,5,5,3,13,Champion
15709,1,133.25,284,1,1,1,3,LOST
15712,5,1072.3600000000001,9,4,4,5,13,Champion
15713,2,356.7,143,3,2,2,7,SomeWhat Loyal
15714,2,330.88,12,3,2,5,10,Loyal
15716,4,1118.81,146,4,4,2,10,Loyal
15717,1,150.3,234,1,1,1,3,LOST
15719,13,5045.61,33,5,5,3,13,Champion
15720,1,598.73,24,1,3,4,8,SomeWhat Loyal
15721,1,507.08,12,1,3,5,9,Loyal
15722,5,2222.56,36,4,5,3,12,Loyal
15723,1,203.1,365,1,1,1,3,LOST
15724,2,218.25,201,3,1,1,5,SomeWhat Loyal
15725,1,415.25,15,1,2,4,7,SomeWhat Loyal
15727,7,5178.96,17,5,5,4,14,Champion
15729,1,85.0,213,1,1,1,3,LOST
15730,3,1120.88,66,3,4,3,10,Loyal
15732,2,294.12,212,3,2,1,6,SomeWhat Loyal
15733,1,162.3,283,1,1,1,3,LOST
15734,2,1339.45,115,3,4,2,9,Loyal
15737,8,1205.1200000000001,15,5,4,4,13,Champion
15738,16,4812.42,19,5,5,4,14,Champion
15739,1,449.12,66,1,2,3,6,SomeWhat Loyal
15740,1,154.88,49,1,1,3,5,SomeWhat Loyal
15743,4,784.46,16,4,3,4,11,Loyal
15744,1,34.8,78,1,1,2,4,Others
15745,4,1094.59,19,4,4,4,12,Loyal
15746,1,196.88,134,1,1,2,4,Others
15747,3,974.04,13,3,4,5,12,Loyal
15748,1,149.31,40,1,1,3,5,SomeWhat Loyal
15749,3,44534.3,235,3,5,1,9,Loyal
15750,8,2465.48,3,5,5,5,15,Champion
15752,7,2637.38,40,5,5,3,13,Champion
15753,1,79.2,305,1,1,1,3,LOST
15754,3,458.57,51,3,2,3,8,SomeWhat Loyal
15755,6,2364.25,10,5,5,5,15,Champion
15756,4,532.96,61,4,3,3,10,Loyal
15757,2,714.42,66,3,3,3,9,Loyal
15758,1,205.25,25,2,1,4,7,SomeWhat Loyal
15759,3,253.04,218,3,2,1,6,SomeWhat Loyal
15762,2,583.75,65,3,3,3,9,Loyal
15763,2,1086.92,32,3,4,4,11,Loyal
15764,6,3279.97,88,5,5,2,12,Loyal
15766,1,315.06,64,2,2,3,7,SomeWhat Loyal
15768,3,621.8299999999999,116,4,3,2,9,Loyal
15769,26,56252.72,7,5,5,5,15,Champion
15773,1,635.6800000000001,6,2,3,5,10,Loyal
15774,1,270.8,69,2,2,3,7,SomeWhat Loyal
15775,1,104.9,245,2,1,1,4,Others
15776,1,241.62,133,2,1,2,5,SomeWhat Loyal
15777,4,1047.11,241,4,4,1,9,Loyal
15780,3,475.28000000000003,184,4,2,1,7,SomeWhat Loyal
15781,3,345.46,25,4,2,4,10,Loyal
15782,3,2614.7400000000002,10,4,5,5,14,Champion
15783,1,246.3,11,2,1,5,8,SomeWhat Loyal
15785,5,2328.9700000000003,33,4,5,3,12,Loyal
15786,3,4932.2,46,4,5,3,12,Loyal
15787,3,948.05,26,4,4,4,12,Loyal
15789,1,351.3,358,2,2,1,5,SomeWhat Loyal
15790,1,220.85,10,2,1,5,8,SomeWhat Loyal
15791,2,1612.69,44,3,4,3,10,Loyal
15793,3,965.61,15,4,4,4,12,Loyal
15795,1,610.01,150,2,3,2,7,SomeWhat Loyal
15796,8,2711.56,1,5,5,5,15,Champion
15797,4,2207.4,113,4,5,2,11,Loyal
15799,3,884.14,76,4,3,2,9,Loyal
15800,2,699.08,107,3,3,2,8,SomeWhat Loyal
15801,3,1063.95,46,4,4,3,11,Loyal
15802,1,451.42,143,2,2,2,6,SomeWhat Loyal
15803,1,415.82000000000005,51,2,2,3,7,SomeWhat Loyal
15804,13,4206.39,1,5,5,5,15,Champion
15805,17,5528.4800000000005,23,5,5,4,14,Champion
15806,3,784.58,46,4,3,3,10,Loyal
15807,3,903.9,50,4,3,3,10,Loyal
15808,4,3734.9700000000003,306,4,5,1,10,Loyal
15809,5,515.77,36,4,3,3,10,Loyal
15810,4,1391.98,79,4,4,2,10,Loyal
15811,6,2218.62,22,5,5,4,14,Champion
15812,5,1801.14,107,4,4,2,10,Loyal
15813,2,1303.9099999999999,208,3,4,1,8,SomeWhat Loyal
15814,4,1945.33,17,4,4,4,12,Loyal
15815,5,2100.6,64,4,5,3,12,Loyal
15819,4,1905.45,49,4,4,3,11,Loyal
15820,1,206.98,320,2,1,1,4,Others
15821,2,570.96,44,3,3,3,9,Loyal
15822,2,885.47,3,3,3,5,11,Loyal
15823,1,15.0,372,2,1,1,4,Others
15825,1,532.94,172,2,3,2,7,SomeWhat Loyal
15826,3,1654.31,56,4,4,3,11,Loyal
15827,14,1836.0900000000001,73,5,4,2,11,Loyal
15829,2,636.14,99,3,3,2,8,SomeWhat Loyal
15830,1,576.0,38,2,3,3,8,SomeWhat Loyal
15831,3,801.76,58,4,3,3,10,Loyal
15832,1,836.79,254,2,3,1,6,SomeWhat Loyal
15834,4,2233.75,70,4,5,3,12,Loyal
15835,4,954.09,44,4,4,3,11,Loyal
15836,1,137.37,50,2,1,3,6,SomeWhat Loyal
15837,1,391.98,65,2,2,3,7,SomeWhat Loyal
15838,19,33643.08,11,5,5,5,15,Champion
15839,3,1048.49,33,4,4,3,11,Loyal
15840,2,355.56,59,3,2,3,8,SomeWhat Loyal
15841,4,1224.06,73,4,4,2,10,Loyal
15843,1,118.95000000000002,304,2,1,1,4,Others
15844,1,130.73999999999998,46,2,1,3,6,SomeWhat Loyal
15845,8,3711.77,18,5,5,4,14,Champion
15847,2,389.27,38,3,2,3,8,SomeWhat Loyal
15850,2,238.85,19,3,1,4,8,SomeWhat Loyal
15852,2,160.71,187,3,1,1,5,SomeWhat Loyal
15853,1,110.8,52,2,1,3,6,SomeWhat Loyal
15854,12,2974.65,4,5,5,5,15,Champion
15855,5,712.24,137,4,3,2,9,Loyal
15856,27,16387.57,4,5,5,5,15,Champion
15857,1,297.0,19,2,2,4,8,SomeWhat Loyal
15858,5,1438.85,16,4,4,4,12,Loyal
15860,8,977.21,41,5,4,3,12,Loyal
15861,8,3165.36,12,5,5,5,15,Champion
15862,4,832.88,8,4,3,5,12,Loyal
15863,2,68.84,26,3,1,4,8,SomeWhat Loyal
15864,6,1936.3200000000002,22,5,4,4,13,Champion
15865,3,895.13,41,4,3,3,10,Loyal
15866,1,230.53,101,2,1,2,5,SomeWhat Loyal
15867,15,3812.64,5,5,5,5,15,Champion
15869,2,149.64,277,3,1,1,5,SomeWhat Loyal
15870,1,354.09000000000003,33,2,2,3,7,SomeWhat Loyal
15872,2,360.93,15,3,2,4,9,Loyal
15874,7,4405.88,64,5,5,3,13,Champion
15877,2,493.28,2,3,3,5,11,Loyal
15880,1,343.28000000000003,369,2,2,1,5,SomeWhat Loyal
15881,5,501.39000000000004,312,4,3,1,8,SomeWhat Loyal
15882,4,516.36,199,4,3,1,8,SomeWhat Loyal
15883,2,396.48,2,3,2,5,10,Loyal
15885,3,379.35,93,4,2,2,8,SomeWhat Loyal
15886,1,181.09,60,2,1,3,6,SomeWhat Loyal
15888,1,168.31,81,2,1,2,5,SomeWhat Loyal
15889,2,446.87,157,3,2,2,7,SomeWhat Loyal
15891,1,524.52,227,2,3,1,6,SomeWhat Loyal
15894,2,263.55,253,3,2,1,6,SomeWhat Loyal
15895,1,179.17,150,2,1,2,5,SomeWhat Loyal
15897,2,222.05,194,3,1,1,5,SomeWhat Loyal
15898,5,1388.88,1,4,4,5,13,Champion
15899,1,56.25,369,2,1,1,4,Others
15900,1,351.11,24,2,2,4,8,SomeWhat Loyal
15901,3,363.88,17,4,2,4,10,Loyal
15903,7,5126.76,10,5,5,5,15,Champion
15904,1,164.68,8,2,1,5,8,SomeWhat Loyal
15906,7,1567.69,20,5,4,4,13,Champion
15907,3,967.45,4,4,4,5,13,Champion
15909,1,191.94,174,2,1,2,5,SomeWhat Loyal
15910,8,1232.18,1,5,4,5,14,Champion
15912,2,264.62,178,3,2,2,7,SomeWhat Loyal
15916,8,1528.09,16,5,4,4,13,Champion
15917,1,123.1,248,2,1,1,4,Others
15918,2,334.23,191,3,2,1,6,SomeWhat Loyal
15919,2,639.89,20,3,3,4,10,Loyal
15920,4,167.5,154,4,1,2,7,SomeWhat Loyal
15921,1,336.03000000000003,173,2,2,2,6,SomeWhat Loyal
15922,1,369.5,373,2,2,1,5,SomeWhat Loyal
15923,1,127.08,373,2,1,1,4,Others
15925,1,207.15,194,2,1,1,4,Others
15930,1,426.63,67,2,2,3,7,SomeWhat Loyal
15932,8,2495.87,4,5,5,5,15,Champion
15933,3,1107.46,21,4,4,4,12,Loyal
15935,2,416.86,239,3,2,1,6,SomeWhat Loyal
15937,1,145.35,64,2,1,3,6,SomeWhat Loyal
15938,5,404.58,112,4,2,2,8,SomeWhat Loyal
15939,15,6115.01,90,5,5,2,12,Loyal
15940,1,35.8,311,2,1,1,4,Others
15942,1,337.44,134,2,2,2,6,SomeWhat Loyal
15944,1,325.1,277,2,2,1,5,SomeWhat Loyal
15945,1,181.0,365,2,1,1,4,Others
15947,1,1708.24,83,2,4,2,8,SomeWhat Loyal
15948,2,955.24,8,3,4,5,12,Loyal
15949,2,364.72,17,3,2,4,9,Loyal
15950,4,1765.51,32,4,4,4,12,Loyal
15951,2,708.22,9,3,3,5,11,Loyal
15952,4,806.57,34,4,3,3,10,Loyal
15953,8,1659.3799999999999,15,5,4,4,13,Champion
15955,14,4416.26,24,5,5,4,14,Champion
15957,1,428.89,32,2,2,4,8,SomeWhat Loyal
15958,1,104.35,74,2,1,2,5,SomeWhat Loyal
15963,2,470.76,20,3,2,4,9,Loyal
15965,4,845.64,17,4,3,4,11,Loyal
15967,2,418.83,23,3,2,4,9,Loyal
15969,3,666.1,3,4,3,5,12,Loyal
15970,1,314.1,304,2,2,1,5,SomeWhat Loyal
15971,12,4199.85,18,5,5,4,14,Champion
15973,1,307.82000000000005,367,2,2,1,5,SomeWhat Loyal
15974,7,3442.15,39,5,5,3,13,Champion
15975,1,371.01,84,2,2,2,6,SomeWhat Loyal
15976,2,430.94,165,3,2,2,7,SomeWhat Loyal
15977,2,1054.73,17,3,4,4,11,Loyal
15978,1,1098.78,77,2,4,2,8,SomeWhat Loyal
15980,3,2398.86,89,4,5,2,11,Loyal
15981,8,3408.48,25,5,5,4,14,Champion
15983,4,1475.02,22,4,4,4,12,Loyal
15984,10,2837.67,3,5,5,5,15,Champion
15985,2,1142.42,123,3,4,2,9,Loyal
15986,1,168.12,30,2,1,4,7,SomeWhat Loyal
15987,7,1451.28,12,5,4,5,14,Champion
15988,1,158.03,19,2,1,4,7,SomeWhat Loyal
15990,2,792.11,44,3,3,3,9,Loyal
15992,1,41.989999999999995,4,2,1,5,8,SomeWhat Loyal
15993,7,2797.57,9,5,5,5,15,Champion
15994,1,427.07,55,2,2,3,7,SomeWhat Loyal
15996,6,1060.68,88,5,4,2,11,Loyal
15998,5,3089.97,37,4,5,3,12,Loyal
16000,3,12393.7,3,4,5,5,14,Champion
16003,5,2735.37,30,4,5,4,13,Champion
16005,4,615.39,12,4,3,5,12,Loyal
16006,1,101.4,211,2,1,1,4,Others
16007,4,1701.94,48,4,4,3,11,Loyal
16008,3,478.78,24,4,2,4,10,Loyal
16009,4,992.71,22,4,4,4,12,Loyal
16010,3,407.5,246,4,2,1,7,SomeWhat Loyal
16011,16,3362.71,8,5,5,5,15,Champion
16012,3,1415.29,35,4,4,3,11,Loyal
16013,47,37130.6,4,5,5,5,15,Champion
16014,3,662.38,38,4,3,3,10,Loyal
16015,3,705.39,4,4,3,5,12,Loyal
16016,8,1508.76,3,5,4,5,14,Champion
16017,1,211.88,47,2,1,3,6,SomeWhat Loyal
16018,2,408.90000000000003,39,3,2,3,8,SomeWhat Loyal
16019,9,3786.2400000000002,47,5,5,3,13,Champion
16020,3,851.01,17,4,3,4,11,Loyal
16022,1,628.28,260,2,3,1,6,SomeWhat Loyal
16023,3,719.81,46,4,3,3,10,Loyal
16024,1,251.24,12,2,2,5,9,Loyal
16025,1,439.65999999999997,30,2,2,4,8,SomeWhat Loyal
16026,1,236.09,43,2,1,3,6,SomeWhat Loyal
16027,6,934.62,92,5,3,2,10,Loyal
16029,63,81024.84,39,5,5,3,13,Champion
16030,1,331.24,310,2,2,1,5,SomeWhat Loyal
16031,2,548.94,92,3,3,2,8,SomeWhat Loyal
16033,20,8816.4,6,5,5,5,15,Champion
16034,3,437.7,196,4,2,1,7,SomeWhat Loyal
16036,2,758.92,87,3,3,2,8,SomeWhat Loyal
16037,3,855.02,270,4,3,1,8,SomeWhat Loyal
16038,3,471.78000000000003,8,4,2,5,11,Loyal
16040,3,1313.55,65,4,4,3,11,Loyal
16041,3,3166.4,31,4,5,4,13,Champion
16042,5,1197.27,22,4,4,4,12,Loyal
16043,4,773.99,38,4,3,3,10,Loyal
16045,4,1340.7,120,4,4,2,10,Loyal
16048,2,256.44,373,3,2,1,6,SomeWhat Loyal
16049,3,1111.79,40,4,4,3,11,Loyal
16050,1,137.9,174,2,1,2,5,SomeWhat Loyal
16052,1,362.06,54,2,2,3,7,SomeWhat Loyal
16053,2,1511.95,33,3,4,3,10,Loyal
16054,1,783.9,145,2,3,2,7,SomeWhat Loyal
16055,1,134.8,221,2,1,1,4,Others
16056,1,664.85,45,2,3,3,8,SomeWhat Loyal
16057,7,2263.12,16,5,5,4,14,Champion
16059,6,1459.8600000000001,66,5,4,3,12,Loyal
16062,4,1153.62,10,4,4,5,13,Champion
16063,1,335.32,260,2,2,1,5,SomeWhat Loyal
16065,1,372.09,365,2,2,1,5,SomeWhat Loyal
16066,5,1521.87,17,4,4,4,12,Loyal
16070,2,852.15,22,3,3,4,10,Loyal
16071,1,326.24,45,2,2,3,7,SomeWhat Loyal
16072,1,584.3199999999999,288,2,3,1,6,SomeWhat Loyal
16073,1,122.39999999999999,297,2,1,1,4,Others
16076,10,2234.73,3,5,5,5,15,Champion
16078,1,79.2,284,2,1,1,4,Others
16079,3,1352.0,17,4,4,4,12,Loyal
16080,2,217.16,82,3,1,2,6,SomeWhat Loyal
16081,5,2806.9,56,4,5,3,12,Loyal
16083,2,1317.62,101,3,4,2,9,Loyal
16084,1,436.18,299,2,2,1,5,SomeWhat Loyal
16085,5,981.51,23,4,4,4,12,Loyal
16086,5,1121.39,59,4,4,3,11,Loyal
16091,2,315.06,155,3,2,2,7,SomeWhat Loyal
16092,3,817.86,115,4,3,2,9,Loyal
16093,1,17.0,107,2,1,2,5,SomeWhat Loyal
16094,4,1078.23,12,4,4,5,13,Champion
16096,1,320.62,264,2,2,1,5,SomeWhat Loyal
16097,1,185.04999999999998,240,2,1,1,4,Others
16098,7,2005.63,88,5,4,2,11,Loyal
16099,3,731.9,50,4,3,3,10,Loyal
16101,1,1290.7,71,2,4,3,9,Loyal
16102,3,1842.14,42,4,4,3,11,Loyal
16103,6,1429.64,7,5,4,5,14,Champion
16104,1,302.36,62,2,2,3,7,SomeWhat Loyal
16105,1,336.96,249,2,2,1,5,SomeWhat Loyal
16106,1,108.38,66,2,1,3,6,SomeWhat Loyal
16107,7,3204.1600000000003,18,5,5,4,14,Champion
16108,1,842.5,85,2,3,2,7,SomeWhat Loyal
16109,2,611.88,219,3,3,1,7,SomeWhat Loyal
16110,3,1337.48,45,4,4,3,11,Loyal
16112,4,195.73999999999998,143,4,1,2,7,SomeWhat Loyal
16113,1,161.38,183,2,1,1,4,Others
16114,1,135.75000000000003,171,2,1,2,5,SomeWhat Loyal
16115,8,1667.97,10,5,4,5,14,Champion
16116,1,612.78,212,2,3,1,6,SomeWhat Loyal
16117,1,232.21,190,2,1,1,4,Others
16119,2,423.36,8,3,2,5,10,Loyal
16120,4,1309.14,59,4,4,3,11,Loyal
16121,2,867.11,57,3,3,3,9,Loyal
16122,4,684.4200000000001,73,4,3,2,9,Loyal
16123,1,307.78,52,2,2,3,7,SomeWhat Loyal
16124,1,249.0,317,2,1,1,4,Others
16125,1,289.35,367,2,2,1,5,SomeWhat Loyal
16126,4,6287.77,29,4,5,4,13,Champion
16127,1,656.25,39,2,3,3,8,SomeWhat Loyal
16128,5,1880.22,18,4,4,4,12,Loyal
16131,6,3506.54,52,5,5,3,13,Champion
16133,33,14589.04,4,5,5,5,15,Champion
16134,2,618.09,22,3,3,4,10,Loyal
16135,1,517.55,263,2,3,1,6,SomeWhat Loyal
16136,3,709.38,60,4,3,3,10,Loyal
16139,3,635.41,19,4,3,4,11,Loyal
16140,2,725.18,66,3,3,3,9,Loyal
16141,1,620.4,88,2,3,2,7,SomeWhat Loyal
16142,1,535.34,250,2,3,1,6,SomeWhat Loyal
16143,6,2424.94,3,5,5,5,15,Champion
16144,1,175.2,247,2,1,1,4,Others
16145,11,3799.4900000000002,9,5,5,5,15,Champion
16146,3,734.13,157,4,3,2,9,Loyal
16147,1,375.0,134,2,2,2,6,SomeWhat Loyal
16148,1,76.32000000000001,296,2,1,1,4,Others
16149,2,280.52,5,3,2,5,10,Loyal
16150,5,2053.02,43,4,4,3,11,Loyal
16152,1,1829.04,269,2,4,1,7,SomeWhat Loyal
16153,5,1824.23,50,4,4,3,11,Loyal
16156,9,3122.04,9,5,5,5,15,Champion
16157,3,656.69,16,4,3,4,11,Loyal
16159,1,348.2,282,2,2,1,5,SomeWhat Loyal
16160,2,1025.44,65,3,4,3,10,Loyal
16161,19,5575.56,2,5,5,5,15,Champion
16162,1,37.4,252,2,1,1,4,Others
16163,2,856.6,232,3,3,1,7,SomeWhat Loyal
16164,3,822.48,17,4,3,4,11,Loyal
16168,27,3787.6,11,5,5,5,15,Champion
16169,4,1822.97,8,4,4,5,13,Champion
16170,6,1885.05,51,5,4,3,12,Loyal
16171,1,73.2,59,2,1,3,6,SomeWhat Loyal
16172,5,1140.21,95,4,4,2,10,Loyal
16173,6,1418.32,16,5,4,4,13,Champion
16174,3,1009.5500000000001,126,4,4,2,10,Loyal
16175,4,1037.59,94,4,4,2,10,Loyal
16177,1,331.95,50,2,2,3,7,SomeWhat Loyal
16178,1,197.9,138,2,1,2,5,SomeWhat Loyal
16179,1,215.83,61,2,1,3,6,SomeWhat Loyal
16180,8,10254.18,100,5,5,2,12,Loyal
16181,1,305.54,73,2,2,2,6,SomeWhat Loyal
16182,4,6617.65,72,4,5,2,11,Loyal
16183,1,338.71000000000004,67,2,2,3,7,SomeWhat Loyal
16184,6,1158.79,64,5,4,3,12,Loyal
16185,2,529.41,17,3,3,4,10,Loyal
16186,12,4006.94,23,5,5,4,14,Champion
16187,15,6911.4400000000005,32,5,5,4,14,Champion
16188,4,981.86,45,4,4,3,11,Loyal
16189,2,215.48,16,3,1,4,8,SomeWhat Loyal
16190,1,215.08,40,2,1,3,6,SomeWhat Loyal
16191,13,5180.52,3,5,5,5,15,Champion
16193,1,314.45,237,2,2,1,5,SomeWhat Loyal
16198,1,400.68100000000004,75,2,2,2,6,SomeWhat Loyal
16200,2,1080.6200000000001,4,3,4,5,12,Loyal
16201,4,1863.47,3,4,4,5,13,Champion
16202,1,365.27,361,2,2,1,5,SomeWhat Loyal
16203,4,592.9,59,4,3,3,10,Loyal
16204,1,405.71,23,2,2,4,8,SomeWhat Loyal
16205,4,761.38,31,4,3,4,11,Loyal
16206,4,537.0600000000001,55,4,3,3,10,Loyal
16207,1,394.38,25,2,2,4,8,SomeWhat Loyal
16208,2,664.26,45,3,3,3,9,Loyal
16209,5,2262.62,89,4,5,2,11,Loyal
16210,18,21086.3,2,5,5,5,15,Champion
16211,1,547.02,89,2,3,2,7,SomeWhat Loyal
16212,2,690.34,19,3,3,4,10,Loyal
16213,1,159.0,79,2,1,2,5,SomeWhat Loyal
16214,3,1062.75,171,4,4,2,10,Loyal
16215,1,242.35,81,2,1,2,5,SomeWhat Loyal
16216,1,914.9300000000001,267,2,3,1,6,SomeWhat Loyal
16217,2,304.25,235,3,2,1,6,SomeWhat Loyal
16218,7,3084.68,30,5,5,4,14,Champion
16221,3,864.86,37,4,3,3,10,Loyal
16222,1,846.72,318,2,3,1,6,SomeWhat Loyal
16224,4,1295.3,57,4,4,3,11,Loyal
16225,5,1096.32,45,4,4,3,11,Loyal
16226,3,255.12,203,4,2,1,7,SomeWhat Loyal
16227,1,314.22,225,2,2,1,5,SomeWhat Loyal
16229,2,1010.6,87,3,4,2,9,Loyal
16230,2,542.03,190,3,3,1,7,SomeWhat Loyal
16232,4,990.88,44,4,4,3,11,Loyal
16233,3,536.6800000000001,71,4,3,3,10,Loyal
16235,5,867.31,41,4,3,3,10,Loyal
16236,1,432.2,78,2,2,2,6,SomeWhat Loyal
16239,2,414.2,57,3,2,3,8,SomeWhat Loyal
16240,2,3718.8,24,3,5,4,12,Loyal
16241,13,2607.87,10,5,5,5,15,Champion
16242,7,3603.21,8,5,5,5,15,Champion
16243,2,409.1,34,3,2,3,8,SomeWhat Loyal
16244,2,1522.75,212,3,4,1,8,SomeWhat Loyal
16245,3,1413.66,24,4,4,4,12,Loyal
16247,1,114.56,170,2,1,2,5,SomeWhat Loyal
16248,1,152.94,62,2,1,3,6,SomeWhat Loyal
16249,5,1800.07,53,4,4,3,11,Loyal
16250,2,389.44,261,3,2,1,6,SomeWhat Loyal
16253,2,3683.86,67,3,5,3,11,Loyal
16255,8,2619.91,17,5,5,4,14,Champion
16256,1,752.4300000000001,267,2,3,1,6,SomeWhat Loyal
16257,1,46.95,177,2,1,2,5,SomeWhat Loyal
16258,5,5203.51,45,4,5,3,12,Loyal
16260,1,1035.45,51,2,4,3,9,Loyal
16261,4,746.83,17,4,3,4,11,Loyal
16265,9,5447.0,9,5,5,5,15,Champion
16266,7,861.89,74,5,3,2,10,Loyal
16268,2,667.65,71,3,3,3,9,Loyal
16270,1,1141.24,353,2,4,1,7,SomeWhat Loyal
16271,5,1429.24,3,4,4,5,13,Champion
16272,1,411.7,117,2,2,2,6,SomeWhat Loyal
16274,1,357.95,373,2,2,1,5,SomeWhat Loyal
16275,1,559.87,197,2,3,1,6,SomeWhat Loyal
16276,1,810.6000000000001,177,2,3,2,7,SomeWhat Loyal
16278,1,566.38,100,2,3,2,7,SomeWhat Loyal
16279,3,1509.58,21,4,4,4,12,Loyal
16281,1,2062.06,72,2,5,2,9,Loyal
16282,1,168.3,340,2,1,1,4,Others
16283,5,1570.81,6,4,4,5,13,Champion
16284,2,823.97,31,3,3,4,10,Loyal
16287,1,142.5,170,2,1,2,5,SomeWhat Loyal
16292,1,302.25,122,2,2,2,6,SomeWhat Loyal
16293,10,2248.9900000000002,22,5,5,4,14,Champion
16295,4,1328.55,10,4,4,5,13,Champion
16297,1,301.9,269,2,2,1,5,SomeWhat Loyal
16298,3,598.2,23,4,3,4,11,Loyal
16302,1,233.22,127,2,1,2,5,SomeWhat Loyal
16303,3,5360.63,26,4,5,4,13,Champion
16305,1,361.21999999999997,139,2,2,2,6,SomeWhat Loyal
16306,6,632.27,214,5,3,1,9,Loyal
16308,4,2560.0,38,4,5,3,12,Loyal
16309,2,706.57,106,3,3,2,8,SomeWhat Loyal
16311,2,616.26,18,3,3,4,10,Loyal
16313,2,274.15000000000003,3,3,2,5,10,Loyal
16315,1,226.37,331,2,1,1,4,Others
16316,8,2938.91,64,5,5,3,13,Champion
16317,3,1341.65,120,4,4,2,10,Loyal
16318,1,328.15,35,2,2,3,7,SomeWhat Loyal
16319,1,404.40000000000003,218,2,2,1,5,SomeWhat Loyal
16320,2,1038.46,172,3,4,2,9,Loyal
16321,5,373.65000000000003,72,4,2,2,8,SomeWhat Loyal
16322,2,326.75,1,3,2,5,10,Loyal
16323,1,207.50000000000003,196,2,1,1,4,Others
16324,3,428.68,128,4,2,2,8,SomeWhat Loyal
16325,3,594.24,47,4,3,3,10,Loyal
16326,14,3110.96,6,5,5,5,15,Champion
16327,6,3844.22,14,5,5,4,14,Champion
16330,3,251.91,18,4,2,4,10,Loyal
16332,7,1593.2,28,5,4,4,13,Champion
16333,22,26626.8,8,5,5,5,15,Champion
16337,1,151.05,37,2,1,3,6,SomeWhat Loyal
16338,1,214.79999999999998,157,2,1,2,5,SomeWhat Loyal
16339,1,109.95,284,2,1,1,4,Others
16340,1,549.07,107,2,3,2,7,SomeWhat Loyal
16341,4,1971.87,25,4,4,4,12,Loyal
16342,4,322.41,75,4,2,2,8,SomeWhat Loyal
16343,2,370.47999999999996,16,3,2,4,9,Loyal
16344,1,101.10000000000001,158,2,1,2,5,SomeWhat Loyal
16345,1,575.41,44,2,3,3,8,SomeWhat Loyal
16347,2,887.65,11,3,3,5,11,Loyal
16348,7,1469.45,32,5,4,4,13,Champion
16349,1,53.5,291,2,1,1,4,Others
16350,4,1116.47,21,4,4,4,12,Loyal
16351,1,153.9,333,2,1,1,4,Others
16352,2,494.44,18,3,3,4,10,Loyal
16353,23,6675.71,4,5,5,5,15,Champion
16354,2,395.8,63,3,2,3,8,SomeWhat Loyal
16356,3,211.77,198,4,1,1,6,SomeWhat Loyal
16357,3,658.88,33,4,3,3,10,Loyal
16358,4,2027.5,1,4,4,5,13,Champion
16359,9,1750.92,7,5,4,5,14,Champion
16360,6,3512.53,5,5,5,5,15,Champion
16361,4,896.66,10,4,3,5,12,Loyal
16362,5,734.77,32,4,3,4,11,Loyal
16363,1,109.36000000000001,53,2,1,3,6,SomeWhat Loyal
16364,2,707.04,12,3,3,5,11,Loyal
16365,9,1540.42,18,5,4,4,13,Champion
16366,1,327.3,19,2,2,4,8,SomeWhat Loyal
16367,2,804.49,37,3,3,3,9,Loyal
16368,2,497.43,2,3,3,5,11,Loyal
16369,3,1553.66,18,4,4,4,12,Loyal
16370,4,1320.56,82,4,4,2,10,Loyal
16372,2,367.93,33,3,2,3,8,SomeWhat Loyal
16374,2,473.03000000000003,66,3,2,3,8,SomeWhat Loyal
16376,2,987.01,9,3,4,5,12,Loyal
16377,1,676.2,267,2,3,1,6,SomeWhat Loyal
16378,3,362.95,247,4,2,1,7,SomeWhat Loyal
16379,4,2157.4,4,4,5,5,14,Champion
16380,1,1780.59,61,2,4,3,9,Loyal
16383,2,668.36,75,3,3,2,8,SomeWhat Loyal
16384,2,584.5,90,3,3,2,8,SomeWhat Loyal
16385,3,555.89,60,4,3,3,10,Loyal
16386,2,317.2,29,3,2,4,9,Loyal
16387,1,94.36,323,2,1,1,4,Others
16389,4,1382.07,53,4,4,3,11,Loyal
16392,1,221.19,270,2,1,1,4,Others
16393,13,3046.21,2,5,5,5,15,Champion
16394,5,1555.34,57,4,4,3,11,Loyal
16395,5,1486.9,61,4,4,3,11,Loyal
16398,2,1705.8,154,3,4,2,9,Loyal
16399,2,408.57,19,3,2,4,9,Loyal
16400,1,303.93,95,2,2,2,6,SomeWhat Loyal
16401,12,4098.32,1,5,5,5,15,Champion
16402,2,299.6,265,3,2,1,6,SomeWhat Loyal
16403,1,177.5,312,2,1,1,4,Others
16404,1,443.05,70,2,2,3,7,SomeWhat Loyal
16405,2,167.25,302,3,1,1,5,SomeWhat Loyal
16406,1,163.07,19,2,1,4,7,SomeWhat Loyal
16407,10,2126.93,13,5,5,5,15,Champion
16409,5,2028.88,36,4,4,3,11,Loyal
16411,2,214.65,19,3,1,4,8,SomeWhat Loyal
16412,1,151.83,54,2,1,3,6,SomeWhat Loyal
16413,1,262.2,57,2,2,3,7,SomeWhat Loyal
16414,2,126.25,22,3,1,4,8,SomeWhat Loyal
16415,1,210.35,44,2,1,3,6,SomeWhat Loyal
16416,3,1051.4,27,4,4,4,12,Loyal
16418,3,675.27,45,4,3,3,10,Loyal
16419,6,972.23,113,5,4,2,11,Loyal
16422,51,34684.4,17,5,5,4,14,Champion
16423,1,346.12,25,2,2,4,8,SomeWhat Loyal
16424,1,133.56,191,2,1,1,4,Others
16425,1,302.7,302,2,2,1,5,SomeWhat Loyal
16426,10,1908.25,2,5,4,5,14,Champion
16427,2,241.06,263,3,1,1,5,SomeWhat Loyal
16429,1,284.55,106,2,2,2,6,SomeWhat Loyal
16430,1,300.85,57,2,2,3,7,SomeWhat Loyal
16431,3,642.81,213,4,3,1,8,SomeWhat Loyal
16432,1,287.4,64,2,2,3,7,SomeWhat Loyal
16433,1,184.26,28,2,1,4,7,SomeWhat Loyal
16434,7,1522.25,29,5,4,4,13,Champion
16438,5,798.35,6,4,3,5,12,Loyal
16440,5,3640.67,8,4,5,5,14,Champion
16441,2,381.2,67,3,2,3,8,SomeWhat Loyal
16442,3,616.79,2,4,3,5,12,Loyal
16444,4,654.67,46,4,3,3,10,Loyal
16445,1,230.51,34,2,1,3,6,SomeWhat Loyal
16446,2,168472.5,1,3,5,5,13,Champion
16447,1,259.01,136,2,2,2,6,SomeWhat Loyal
16448,1,188.89000000000001,198,2,1,1,4,Others
16449,2,707.69,198,3,3,1,7,SomeWhat Loyal
16450,1,311.92,150,2,2,2,6,SomeWhat Loyal
16451,1,266.97,88,2,2,2,6,SomeWhat Loyal
16454,2,6.9,45,3,1,3,7,SomeWhat Loyal
16455,7,1841.18,64,5,4,3,12,Loyal
16456,5,2158.37,99,4,5,2,11,Loyal
16457,1,208.36,218,2,1,1,4,Others
16458,18,3482.7400000000002,3,5,5,5,15,Champion
16460,3,814.72,28,4,3,4,11,Loyal
16461,1,151.42,178,2,1,2,5,SomeWhat Loyal
16462,3,136.0,74,4,1,2,7,SomeWhat Loyal
16463,4,1422.4,21,4,4,4,12,Loyal
16464,3,1314.68,20,4,4,4,12,Loyal
16466,7,1603.46,34,5,4,3,12,Loyal
16468,1,74.9,74,2,1,2,5,SomeWhat Loyal
16469,4,650.43,24,4,3,4,11,Loyal
16470,4,762.39,52,4,3,3,10,Loyal
16471,1,223.95000000000002,275,2,1,1,4,Others
16473,3,316.11,165,4,2,2,8,SomeWhat Loyal
16474,7,1871.5,7,5,4,5,14,Champion
16475,4,544.3,88,4,3,2,9,Loyal
16477,7,2494.46,64,5,5,3,13,Champion
16478,3,331.0,25,4,2,4,10,Loyal
16479,2,300.83,10,3,2,5,10,Loyal
16480,1,769.29,76,2,3,2,7,SomeWhat Loyal
16482,1,220.62,16,2,1,4,7,SomeWhat Loyal
16483,1,139.35,192,2,1,1,4,Others
16484,2,404.3,174,3,2,2,7,SomeWhat Loyal
16485,1,363.65,77,2,2,2,6,SomeWhat Loyal
16488,3,498.8,33,4,3,3,10,Loyal
16491,1,731.5,47,2,3,3,8,SomeWhat Loyal
16493,4,1351.63,80,4,4,2,10,Loyal
16494,1,826.53,297,2,3,1,6,SomeWhat Loyal
16495,3,684.41,3,4,3,5,12,Loyal
16496,3,1599.52,9,4,4,5,13,Champion
16497,6,2965.69,50,5,5,3,13,Champion
16498,2,100.97,161,3,1,2,6,SomeWhat Loyal
16499,2,365.45,360,3,2,1,6,SomeWhat Loyal
16500,6,400.86,5,5,2,5,12,Loyal
16503,4,1431.93,107,4,4,2,10,Loyal
16504,1,484.38,25,2,2,4,8,SomeWhat Loyal
16505,1,777.6,32,2,3,4,9,Loyal
16506,2,90.30000000000001,20,3,1,4,8,SomeWhat Loyal
16509,1,363.7,297,2,2,1,5,SomeWhat Loyal
16510,1,248.1,372,2,1,1,4,Others
16511,3,950.26,22,4,4,4,12,Loyal
16513,4,874.59,5,4,3,5,12,Loyal
16515,5,1627.13,52,4,4,3,11,Loyal
16516,1,101.69999999999999,30,2,1,4,7,SomeWhat Loyal
16517,1,162.7,277,2,1,1,4,Others
16518,2,484.32,61,3,2,3,8,SomeWhat Loyal
16519,2,215.07999999999998,25,3,1,4,8,SomeWhat Loyal
16520,3,1046.57,186,4,4,1,9,Loyal
16523,21,9418.470000000001,2,5,5,5,15,Champion
16525,26,13027.45,2,5,5,5,15,Champion
16526,1,290.36,172,2,2,2,6,SomeWhat Loyal
16527,1,228.06,81,2,1,2,5,SomeWhat Loyal
16528,1,244.41,4,2,1,5,8,SomeWhat Loyal
16529,1,455.25,190,2,2,1,5,SomeWhat Loyal
16531,7,1244.59,22,5,4,4,13,Champion
16532,3,6748.8,18,4,5,4,13,Champion
16533,3,1095.56,19,4,4,4,12,Loyal
16535,1,593.75,5,2,3,5,10,Loyal
16536,1,548.97,110,2,3,2,7,SomeWhat Loyal
16539,4,1388.81,3,4,4,5,13,Champion
16542,1,119.62,54,2,1,3,6,SomeWhat Loyal
16545,1,339.3,165,2,2,2,6,SomeWhat Loyal
16546,2,787.15,291,3,3,1,7,SomeWhat Loyal
16549,10,4154.64,10,5,5,5,15,Champion
16550,5,2298.97,109,4,5,2,11,Loyal
16551,3,922.12,96,4,3,2,9,Loyal
16552,2,379.73,243,3,2,1,6,SomeWhat Loyal
16553,12,5719.82,163,5,5,2,12,Loyal
16554,3,837.1,42,4,3,3,10,Loyal
16555,2,285.89,35,3,2,3,8,SomeWhat Loyal
16556,7,3313.79,67,5,5,3,13,Champion
16557,2,281.85,24,3,2,4,9,Loyal
16558,20,8338.49,1,5,5,5,15,Champion
16560,2,841.41,27,3,3,4,10,Loyal
16561,2,511.12,6,3,3,5,11,Loyal
16563,1,1077.74,54,2,4,3,9,Loyal
16565,1,173.7,364,2,1,1,4,Others
16566,5,614.66,15,4,3,4,11,Loyal
16567,2,865.6,194,3,3,1,7,SomeWhat Loyal
16569,1,124.2,3,2,1,5,8,SomeWhat Loyal
16570,10,3738.4,15,5,5,4,14,Champion
16571,3,1421.69,27,4,4,4,12,Loyal
16572,3,1009.6,127,4,4,2,10,Loyal
16573,2,663.61,85,3,3,2,8,SomeWhat Loyal
16574,1,451.44,71,2,2,3,7,SomeWhat Loyal
16581,1,105.84,183,2,1,1,4,Others
16582,1,313.62,113,2,2,2,6,SomeWhat Loyal
16583,1,233.45,374,2,1,1,4,Others
16584,2,936.08,80,3,3,2,8,SomeWhat Loyal
16586,1,463.95,249,2,2,1,5,SomeWhat Loyal
16587,1,225.15,232,2,1,1,4,Others
16589,3,459.24,71,4,2,3,9,Loyal
16591,1,213.5,69,2,1,3,6,SomeWhat Loyal
16592,16,4113.68,4,5,5,5,15,Champion
16593,3,330.03,51,4,2,3,9,Loyal
16594,1,181.09,75,2,1,2,5,SomeWhat Loyal
16595,1,360.16,61,2,2,3,7,SomeWhat Loyal
16596,2,250.15,16,3,1,4,8,SomeWhat Loyal
16597,1,90.04,4,2,1,5,8,SomeWhat Loyal
16598,1,145.04999999999998,286,2,1,1,4,Others
16600,6,813.52,4,5,3,5,13,Champion
16601,1,244.79999999999998,41,2,1,3,6,SomeWhat Loyal
16602,1,528.08,36,2,3,3,8,SomeWhat Loyal
16603,2,482.47,75,3,2,2,7,SomeWhat Loyal
16607,14,3347.71,18,5,5,4,14,Champion
16609,7,5493.46,15,5,5,4,14,Champion
16610,1,75.66,219,2,1,1,4,Others
16611,1,129.49,186,2,1,1,4,Others
16612,4,1187.66,33,4,4,3,11,Loyal
16613,1,618.59,70,2,3,3,8,SomeWhat Loyal
16614,1,506.19,183,2,3,1,6,SomeWhat Loyal
16616,2,500.42,15,3,3,4,10,Loyal
16617,1,151.85,236,2,1,1,4,Others
16618,5,2647.59,31,4,5,4,13,Champion
16619,1,226.21,264,2,1,1,4,Others
16620,2,178.96,4,3,1,5,9,Loyal
16621,4,813.48,52,4,3,3,10,Loyal
16623,1,129.45,246,2,1,1,4,Others
16624,2,810.5699999999999,81,3,3,2,8,SomeWhat Loyal
16625,1,333.08,275,2,2,1,5,SomeWhat Loyal
16626,17,4413.1,1,5,5,5,15,Champion
16627,1,322.8,79,2,2,2,6,SomeWhat Loyal
16628,5,2188.05,30,4,5,4,13,Champion
16629,2,417.73,74,3,2,2,7,SomeWhat Loyal
16633,6,2883.1,17,5,5,4,14,Champion
16634,2,217.9,223,3,1,1,5,SomeWhat Loyal
16637,4,1154.47,32,4,4,4,12,Loyal
16638,10,1680.72,23,5,4,4,13,Champion
16639,3,1257.51,31,4,4,4,12,Loyal
16641,1,231.10000000000002,106,2,1,2,5,SomeWhat Loyal
16642,2,688.33,5,3,3,5,11,Loyal
16643,1,487.51,246,2,2,1,5,SomeWhat Loyal
16644,2,833.78,178,3,3,2,8,SomeWhat Loyal
16647,2,214.06,170,3,1,2,6,SomeWhat Loyal
16648,1,290.65999999999997,43,2,2,3,7,SomeWhat Loyal
16650,1,518.42,72,2,3,2,7,SomeWhat Loyal
16652,7,6773.97,59,5,5,3,13,Champion
16653,2,1212.66,16,3,4,4,11,Loyal
16654,4,601.27,141,4,3,2,9,Loyal
16655,6,3794.52,18,5,5,4,14,Champion
16656,15,8625.8,22,5,5,4,14,Champion
16657,4,933.62,10,4,3,5,12,Loyal
16658,1,123.24,368,2,1,1,4,Others
16659,1,39.12,189,2,1,1,4,Others
16660,4,1267.6499999999999,16,4,4,4,12,Loyal
16665,1,135.39999999999998,362,2,1,1,4,Others
16666,1,118.98,19,2,1,4,7,SomeWhat Loyal
16667,2,570.13,68,3,3,3,9,Loyal
16668,6,306.71999999999997,15,5,2,4,11,Loyal
16669,3,1374.8700000000001,24,4,4,4,12,Loyal
16670,11,4095.9,17,5,5,4,14,Champion
16671,3,1692.27,28,4,4,4,12,Loyal
16672,20,8134.9400000000005,2,5,5,5,15,Champion
16674,2,319.61,55,3,2,3,8,SomeWhat Loyal
16676,4,1592.1200000000001,34,4,4,3,11,Loyal
16678,12,3109.99,3,5,5,5,15,Champion
16679,1,129.75,366,2,1,1,4,Others
16680,1,183.7,43,2,1,3,6,SomeWhat Loyal
16681,6,1770.34,73,5,4,2,11,Loyal
16682,5,1028.0,5,4,4,5,13,Champion
16684,28,66653.56,4,5,5,5,15,Champion
16685,2,324.24,61,3,2,3,8,SomeWhat Loyal
16686,7,3062.83,47,5,5,3,13,Champion
16688,4,1260.86,1,4,4,5,13,Champion
16689,2,422.59999999999997,76,3,2,2,7,SomeWhat Loyal
16690,2,225.57999999999998,72,3,1,2,6,SomeWhat Loyal
16692,2,1276.0,256,3,4,1,8,SomeWhat Loyal
16693,2,482.01,69,3,2,3,8,SomeWhat Loyal
16696,4,657.9000000000001,135,4,3,2,9,Loyal
16697,1,112.75,241,2,1,1,4,Others
16698,2,1998.0,227,3,4,1,8,SomeWhat Loyal
16700,13,5076.55,9,5,5,5,15,Champion
16701,13,5398.3,9,5,5,5,15,Champion
16705,20,14034.99,1,5,5,5,15,Champion
16706,3,531.35,37,4,3,3,10,Loyal
16708,1,656.63,46,2,3,3,8,SomeWhat Loyal
16709,5,3029.87,85,4,5,2,11,Loyal
16710,10,2483.04,19,5,5,4,14,Champion
16711,5,1651.03,3,4,4,5,13,Champion
16712,11,3645.43,9,5,5,5,15,Champion
16713,15,6923.13,19,5,5,4,14,Champion
16714,3,1161.53,219,4,4,1,9,Loyal
16715,1,301.71999999999997,78,2,2,2,6,SomeWhat Loyal
16716,2,901.2,267,3,3,1,7,SomeWhat Loyal
16717,6,3858.38,24,5,5,4,14,Champion
16718,1,623.75,369,2,3,1,6,SomeWhat Loyal
16719,7,1790.42,15,5,4,4,13,Champion
16720,1,155.24,26,2,1,4,7,SomeWhat Loyal
16721,1,292.47,262,2,2,1,5,SomeWhat Loyal
16722,13,4730.81,17,5,5,4,14,Champion
16723,2,589.15,91,3,3,2,8,SomeWhat Loyal
16725,7,781.02,302,5,3,1,9,Loyal
16726,5,1382.02,26,4,4,4,12,Loyal
16727,1,272.82,364,2,2,1,5,SomeWhat Loyal
16728,4,1054.67,46,4,4,3,11,Loyal
16729,21,7239.92,38,5,5,3,13,Champion
16730,3,743.11,52,4,3,3,10,Loyal
16732,1,603.75,32,2,3,4,9,Loyal
16734,3,650.51,52,4,3,3,10,Loyal
16735,5,2300.56,79,4,5,2,11,Loyal
16737,1,417.59999999999997,53,2,2,3,7,SomeWhat Loyal
16738,1,3.75,298,2,1,1,4,Others
16739,1,323.0,177,2,2,2,6,SomeWhat Loyal
16742,1,464.9,47,2,2,3,7,SomeWhat Loyal
16743,7,2238.09,29,5,5,4,14,Champion
16744,7,1304.76,11,5,4,5,14,Champion
16745,17,7194.3,87,5,5,2,12,Loyal
16746,18,6697.66,5,5,5,5,15,Champion
16747,2,836.06,38,3,3,3,9,Loyal
16748,5,1515.9,18,4,4,4,12,Loyal
16750,5,623.93,45,4,3,3,10,Loyal
16751,1,1764.72,31,2,4,4,10,Loyal
16752,1,207.5,373,2,1,1,4,Others
16753,1,223.92000000000002,58,2,1,3,6,SomeWhat Loyal
16754,1,2002.4,372,2,4,1,7,SomeWhat Loyal
16755,3,1496.83,114,4,4,2,10,Loyal
16756,1,239.4,215,2,1,1,4,Others
16757,1,106.83000000000001,319,2,1,1,4,Others
16758,1,369.34000000000003,65,2,2,3,7,SomeWhat Loyal
16759,3,789.79,8,4,3,5,12,Loyal
16761,1,316.62,97,2,2,2,6,SomeWhat Loyal
16762,3,1501.38,20,4,4,4,12,Loyal
16763,1,611.85,199,2,3,1,6,SomeWhat Loyal
16764,13,2799.25,4,5,5,5,15,Champion
16765,1,34.0,294,2,1,1,4,Others
16766,2,1145.6,273,3,4,1,8,SomeWhat Loyal
16767,11,5580.6,31,5,5,4,14,Champion
16768,3,478.09000000000003,48,4,2,3,9,Loyal
16769,1,380.39,260,2,2,1,5,SomeWhat Loyal
16770,5,770.1,58,4,3,3,10,Loyal
16771,5,2246.81,33,4,5,3,12,Loyal
16773,1,171.59,57,2,1,3,6,SomeWhat Loyal
16774,4,661.52,68,4,3,3,10,Loyal
16775,11,1695.66,10,5,4,5,14,Champion
16776,1,388.28,60,2,2,3,7,SomeWhat Loyal
16777,2,226.35,80,3,1,2,6,SomeWhat Loyal
16778,2,245.94,74,3,1,2,6,SomeWhat Loyal
16779,22,10629.720000000001,2,5,5,5,15,Champion
16780,2,425.19,100,3,2,2,7,SomeWhat Loyal
16781,1,311.25,372,2,2,1,5,SomeWhat Loyal
16782,13,2279.9,10,5,5,5,15,Champion
16784,1,107.6,20,2,1,4,7,SomeWhat Loyal
16788,2,597.48,123,3,3,2,8,SomeWhat Loyal
16789,1,80.8,8,2,1,5,8,SomeWhat Loyal
16790,6,1545.6200000000001,4,5,4,5,14,Champion
16791,7,1721.78,29,5,4,4,13,Champion
16792,2,110.38000000000001,282,3,1,1,5,SomeWhat Loyal
16793,1,243.84,57,2,1,3,6,SomeWhat Loyal
16794,10,1222.71,1,5,4,5,14,Champion
16795,1,414.88,365,2,2,1,5,SomeWhat Loyal
16796,1,305.62,89,2,2,2,6,SomeWhat Loyal
16800,1,1201.49,11,2,4,5,11,Loyal
16801,4,1619.73,163,4,4,2,10,Loyal
16803,1,332.3,65,2,2,3,7,SomeWhat Loyal
16804,3,536.99,23,4,3,4,11,Loyal
16805,2,460.59,174,3,2,2,7,SomeWhat Loyal
16806,4,801.49,103,4,3,2,9,Loyal
16807,3,1121.59,143,4,4,2,10,Loyal
16808,2,288.42,99,3,2,2,7,SomeWhat Loyal
16809,5,914.69,23,4,3,4,11,Loyal
16810,1,309.54,192,2,2,1,5,SomeWhat Loyal
16811,2,547.07,5,3,3,5,11,Loyal
16812,1,479.35,361,2,2,1,5,SomeWhat Loyal
16813,10,1692.98,8,5,4,5,14,Champion
16814,21,6509.1,14,5,5,4,14,Champion
16816,4,417.06,103,4,2,2,8,SomeWhat Loyal
16817,9,1604.75,3,5,4,5,14,Champion
16818,11,3349.57,11,5,5,5,15,Champion
16820,1,497.61,96,2,3,2,7,SomeWhat Loyal
16823,1,358.38,227,2,2,1,5,SomeWhat Loyal
16824,2,460.64,16,3,2,4,9,Loyal
16825,2,775.1800000000001,39,3,3,3,9,Loyal
16826,1,341.7,51,2,2,3,7,SomeWhat Loyal
16828,2,128.5,93,3,1,2,6,SomeWhat Loyal
16829,1,197.22,157,2,1,2,5,SomeWhat Loyal
16830,1,325.91,39,2,2,3,7,SomeWhat Loyal
16832,3,199.15,184,4,1,1,6,SomeWhat Loyal
16833,4,1106.53,1,4,4,5,13,Champion
16834,1,413.46,228,2,2,1,5,SomeWhat Loyal
16835,2,180.85,128,3,1,2,6,SomeWhat Loyal
16836,2,251.87,40,3,2,3,8,SomeWhat Loyal
16837,11,3170.98,31,5,5,4,14,Champion
16838,2,588.85,197,3,3,1,7,SomeWhat Loyal
16839,34,16594.35,9,5,5,5,15,Champion
16841,6,1869.82,37,5,4,3,12,Loyal
16842,3,1264.19,101,4,4,2,10,Loyal
16843,16,10196.57,43,5,5,3,13,Champion
16846,1,214.32,50,2,1,3,6,SomeWhat Loyal
16847,1,193.44,43,2,1,3,6,SomeWhat Loyal
16848,1,281.42,53,2,2,3,7,SomeWhat Loyal
16849,1,124.57,187,2,1,1,4,Others
16850,1,332.41,334,2,2,1,5,SomeWhat Loyal
16851,3,342.45,4,4,2,5,11,Loyal
16852,2,144.91000000000003,10,3,1,5,9,Loyal
16855,2,328.4,24,3,2,4,9,Loyal
16856,1,35.400000000000006,15,2,1,4,7,SomeWhat Loyal
16858,1,375.69000000000005,369,2,2,1,5,SomeWhat Loyal
16859,2,747.81,145,3,3,2,8,SomeWhat Loyal
16861,2,173.76,60,3,1,3,7,SomeWhat Loyal
16863,2,502.8,31,3,3,4,10,Loyal
16866,3,207.73999999999998,141,4,1,2,7,SomeWhat Loyal
16869,4,825.42,23,4,3,4,11,Loyal
16871,6,2812.34,22,5,5,4,14,Champion
16872,3,680.02,77,4,3,2,9,Loyal
16873,6,7123.62,5,5,5,5,15,Champion
16875,5,2095.53,67,4,5,3,12,Loyal
16877,6,853.72,12,5,3,5,13,Champion
16878,1,13.3,84,2,1,2,5,SomeWhat Loyal
16880,7,1519.08,31,5,4,4,13,Champion
16881,1,432.0,67,2,2,3,7,SomeWhat Loyal
16882,3,705.12,67,4,3,3,10,Loyal
16883,2,276.73,187,3,2,1,6,SomeWhat Loyal
16884,2,429.84000000000003,38,3,2,3,8,SomeWhat Loyal
16885,3,471.51,15,4,2,4,10,Loyal
16887,1,194.88,35,2,1,3,6,SomeWhat Loyal
16889,3,1578.67,195,4,4,1,9,Loyal
16891,5,809.7,2,4,3,5,12,Loyal
16892,5,525.54,1,4,3,5,12,Loyal
16893,1,145.93,367,2,1,1,4,Others
16895,1,219.14,65,2,1,3,6,SomeWhat Loyal
16897,2,289.78,299,3,2,1,6,SomeWhat Loyal
16898,3,508.81,26,4,3,4,11,Loyal
16899,6,1281.56,8,5,4,5,14,Champion
16900,3,887.11,17,4,3,4,11,Loyal
16902,1,1706.88,116,2,4,2,8,SomeWhat Loyal
16903,1,373.24,29,2,2,4,8,SomeWhat Loyal
16904,16,3754.27,4,5,5,5,15,Champion
16905,7,3102.43,5,5,5,5,15,Champion
16906,4,579.77,82,4,3,2,9,Loyal
16907,5,981.65,29,4,4,4,12,Loyal
16909,1,379.14,72,2,2,2,6,SomeWhat Loyal
16910,8,1510.06,4,5,4,5,14,Champion
16912,11,2575.38,29,5,5,4,14,Champion
16913,1,113.44,290,2,1,1,4,Others
16914,1,208.46,36,2,1,3,6,SomeWhat Loyal
16915,6,621.6800000000001,9,5,3,5,13,Champion
16916,2,576.26,24,3,3,4,10,Loyal
16917,1,391.52,277,2,2,1,5,SomeWhat Loyal
16918,6,1068.82,50,5,4,3,12,Loyal
16919,11,2596.45,156,5,5,2,12,Loyal
16921,1,169.79,61,2,1,3,6,SomeWhat Loyal
16923,19,7247.61,12,5,5,5,15,Champion
16924,3,846.75,21,4,3,4,11,Loyal
16926,1,230.25,371,2,1,1,4,Others
16927,3,543.05,116,4,3,2,9,Loyal
16928,17,2847.6,80,5,5,2,12,Loyal
16929,7,1295.39,4,5,4,5,14,Champion
16930,3,380.55,26,4,2,4,10,Loyal
16931,21,4604.22,5,5,5,5,15,Champion
16932,1,161.94,53,2,1,3,6,SomeWhat Loyal
16933,2,563.23,1,3,3,5,11,Loyal
16934,2,950.9300000000001,55,3,4,3,10,Loyal
16936,1,262.68,26,2,2,4,8,SomeWhat Loyal
16938,4,2736.38,9,4,5,5,14,Champion
16940,3,3049.88,52,4,5,3,12,Loyal
16942,9,1920.59,13,5,4,5,14,Champion
16943,3,816.73,212,4,3,1,8,SomeWhat Loyal
16945,19,4345.5,22,5,5,4,14,Champion
16947,1,406.48,236,2,2,1,5,SomeWhat Loyal
16948,3,435.02,139,4,2,2,8,SomeWhat Loyal
16949,6,1286.27,4,5,4,5,14,Champion
16950,3,1178.56,57,4,4,3,11,Loyal
16951,3,1277.75,135,4,4,2,10,Loyal
16952,2,167.61,109,3,1,2,6,SomeWhat Loyal
16953,1,20.8,30,2,1,4,7,SomeWhat Loyal
16954,9,2085.08,1,5,5,5,15,Champion
16955,4,518.67,185,4,3,1,8,SomeWhat Loyal
16956,1,308.74,18,2,2,4,8,SomeWhat Loyal
16957,2,416.64,239,3,2,1,6,SomeWhat Loyal
16959,1,117.35000000000001,87,2,1,2,5,SomeWhat Loyal
16960,3,507.05,39,4,3,3,10,Loyal
16961,1,234.17,116,2,1,2,5,SomeWhat Loyal
16963,1,110.55000000000001,187,2,1,1,4,Others
16965,1,201.19,227,2,1,1,4,Others
16966,7,2154.97,8,5,5,5,15,Champion
16967,1,319.02,189,2,2,1,5,SomeWhat Loyal
16968,2,439.43,4,3,2,5,10,Loyal
16969,3,650.41,39,4,3,3,10,Loyal
16971,1,357.21,38,2,2,3,7,SomeWhat Loyal
16976,1,251.51999999999998,267,2,2,1,5,SomeWhat Loyal
16978,1,344.33,78,2,2,2,6,SomeWhat Loyal
16979,6,1852.0,4,5,4,5,14,Champion
16980,2,1078.96,255,3,4,1,8,SomeWhat Loyal
16982,1,384.06,61,2,2,3,7,SomeWhat Loyal
16983,7,1931.25,13,5,4,5,14,Champion
16984,2,4481.35,88,3,5,2,10,Loyal
16985,10,5464.12,17,5,5,4,14,Champion
16986,2,1873.2,30,3,4,4,11,Loyal
16987,7,1625.05,3,5,4,5,14,Champion
16988,1,126.12,5,2,1,5,8,SomeWhat Loyal
16989,6,1133.25,7,5,4,5,14,Champion
16990,1,179.0,219,2,1,1,4,Others
16992,5,1614.31,11,4,4,5,13,Champion
16996,6,1456.96,30,5,4,4,13,Champion
16997,3,702.0,288,4,3,1,8,SomeWhat Loyal
16998,4,295.0,150,4,2,2,8,SomeWhat Loyal
16999,2,484.82,23,3,2,4,9,Loyal
17001,11,3989.57,1,5,5,5,15,Champion
17002,3,1493.73,86,4,4,2,10,Loyal
17004,2,1412.94,46,3,4,3,10,Loyal
17006,4,781.78,5,4,3,5,12,Loyal
17007,6,889.9300000000001,51,5,3,3,11,Loyal
17010,1,195.36,18,2,1,4,7,SomeWhat Loyal
17011,1,270.9,30,2,2,4,8,SomeWhat Loyal
17014,3,586.33,8,4,3,5,12,Loyal
17015,3,1842.56,29,4,4,4,12,Loyal
17017,20,8694.26,3,5,5,5,15,Champion
17018,2,920.1,41,3,3,3,9,Loyal
17019,4,1272.61,11,4,4,5,13,Champion
17022,1,71.0,31,2,1,4,7,SomeWhat Loyal
17024,3,95.85,45,4,1,3,8,SomeWhat Loyal
17025,3,357.77,61,4,2,3,9,Loyal
17026,2,154.82999999999998,185,3,1,1,5,SomeWhat Loyal
17027,6,890.29,79,5,3,2,10,Loyal
17029,2,716.0,111,3,3,2,8,SomeWhat Loyal
17030,1,146.87,64,2,1,3,6,SomeWhat Loyal
17031,2,380.35,12,3,2,5,10,Loyal
17033,3,1030.14,86,4,4,2,10,Loyal
17034,3,745.52,16,4,3,4,11,Loyal
17035,2,433.53000000000003,246,3,2,1,6,SomeWhat Loyal
17037,1,1267.32,88,2,4,2,8,SomeWhat Loyal
17038,1,112.4,30,2,1,4,7,SomeWhat Loyal
17040,1,449.73,138,2,2,2,6,SomeWhat Loyal
17041,3,1081.57,27,4,4,4,12,Loyal
17042,5,1044.3799999999999,3,4,4,5,13,Champion
17043,4,1735.18,32,4,4,4,12,Loyal
17044,1,948.48,25,2,4,4,10,Loyal
17045,3,339.44,113,4,2,2,8,SomeWhat Loyal
17046,1,642.02,157,2,3,2,7,SomeWhat Loyal
17047,3,1100.9,85,4,4,2,10,Loyal
17048,3,925.35,118,4,3,2,9,Loyal
17049,9,5659.9800000000005,3,5,5,5,15,Champion
17050,6,3228.84,96,5,5,2,12,Loyal
17051,1,247.14000000000001,194,2,1,1,4,Others
17052,1,413.75,28,2,2,4,8,SomeWhat Loyal
17053,1,498.48,131,2,3,2,7,SomeWhat Loyal
17054,5,1356.33,28,4,4,4,12,Loyal
17058,3,1179.89,82,4,4,2,10,Loyal
17059,5,3095.04,30,4,5,4,13,Champion
17060,1,234.24,266,2,1,1,4,Others
17061,11,5232.2300000000005,74,5,5,2,12,Loyal
17062,4,538.37,314,4,3,1,8,SomeWhat Loyal
17063,7,1461.14,21,5,4,4,13,Champion
17064,3,859.35,59,4,3,3,10,Loyal
17068,21,4552.14,12,5,5,5,15,Champion
17069,9,2709.7000000000003,28,5,5,4,14,Champion
17070,1,312.14,114,2,2,2,6,SomeWhat Loyal
17071,9,2429.03,28,5,5,4,14,Champion
17073,4,1446.09,18,4,4,4,12,Loyal
17075,4,834.12,18,4,3,4,11,Loyal
17076,3,841.0799999999999,36,4,3,3,10,Loyal
17078,2,378.2,36,3,2,3,8,SomeWhat Loyal
17079,1,118.80000000000001,78,2,1,2,5,SomeWhat Loyal
17080,2,287.62,22,3,2,4,9,Loyal
17081,2,290.16,25,3,2,4,9,Loyal
17082,2,2003.85,33,3,4,3,10,Loyal
17083,3,1405.78,109,4,4,2,10,Loyal
17084,2,2949.75,35,3,5,3,11,Loyal
17085,5,1566.65,123,4,4,2,10,Loyal
17086,6,2050.08,7,5,4,5,14,Champion
17088,4,1991.01,28,4,4,4,12,Loyal
17090,7,2043.95,4,5,4,5,14,Champion
17091,9,3827.76,3,5,5,5,15,Champion
17092,4,1777.78,50,4,4,3,11,Loyal
17094,1,302.0,322,2,2,1,5,SomeWhat Loyal
17095,3,1324.16,23,4,4,4,12,Loyal
17096,4,1022.13,15,4,4,4,12,Loyal
17097,8,954.42,2,5,4,5,14,Champion
17100,2,971.74,18,3,4,4,11,Loyal
17101,4,1621.73,10,4,4,5,13,Champion
17102,1,25.5,262,2,1,1,4,Others
17105,2,665.78,159,3,3,2,8,SomeWhat Loyal
17107,6,10815.43,33,5,5,3,13,Champion
17109,6,885.04,29,5,3,4,12,Loyal
17110,1,163.29999999999998,165,2,1,2,5,SomeWhat Loyal
17111,1,248.61,47,2,1,3,6,SomeWhat Loyal
17114,8,808.62,6,5,3,5,13,Champion
17115,3,837.5,8,4,3,5,12,Loyal
17117,1,116.19999999999999,288,2,1,1,4,Others
17118,1,157.02,318,2,1,1,4,Others
17119,2,606.91,3,3,3,5,11,Loyal
17120,1,307.46,233,2,2,1,5,SomeWhat Loyal
17122,1,138.32,119,2,1,2,5,SomeWhat Loyal
17123,1,345.29999999999995,162,2,2,2,6,SomeWhat Loyal
17124,1,298.89,185,2,2,1,5,SomeWhat Loyal
17125,1,259.35,50,2,2,3,7,SomeWhat Loyal
17126,5,1004.75,152,4,4,2,10,Loyal
17128,1,157.09,335,2,1,1,4,Others
17131,5,2463.17,5,4,5,5,14,Champion
17133,7,4892.240000000001,16,5,5,4,14,Champion
17134,2,425.0,107,3,2,2,7,SomeWhat Loyal
17135,7,1139.73,16,5,4,4,13,Champion
17138,1,380.5,276,2,2,1,5,SomeWhat Loyal
17139,12,10668.47,16,5,5,4,14,Champion
17140,1,465.32,247,2,2,1,5,SomeWhat Loyal
17142,1,579.0,239,2,3,1,6,SomeWhat Loyal
17144,2,984.57,1,3,4,5,12,Loyal
17146,3,749.78,106,4,3,2,9,Loyal
17147,4,1714.59,23,4,4,4,12,Loyal
17148,1,124.88,52,2,1,3,6,SomeWhat Loyal
17152,3,1689.5,195,4,4,1,9,Loyal
17153,1,213.78,24,2,1,4,7,SomeWhat Loyal
17154,1,329.34,75,2,2,2,6,SomeWhat Loyal
17155,2,251.70000000000002,18,3,2,4,9,Loyal
17157,2,319.0,8,3,2,5,10,Loyal
17158,3,1266.97,32,4,4,4,12,Loyal
17159,3,1538.88,22,4,4,4,12,Loyal
17160,6,3518.03,31,5,5,4,14,Champion
17162,10,1715.46,29,5,4,4,13,Champion
17163,2,293.1,22,3,2,4,9,Loyal
17164,7,2467.35,33,5,5,3,13,Champion
17165,1,158.68,284,2,1,1,4,Others
17166,2,206.34,39,3,1,3,7,SomeWhat Loyal
17169,2,835.78,58,3,3,3,9,Loyal
17171,1,224.91,289,2,1,1,4,Others
17172,1,317.76,79,2,2,2,6,SomeWhat Loyal
17173,8,3766.6,5,5,5,5,15,Champion
17174,1,59.9,218,2,1,1,4,Others
17175,4,1443.69,44,4,4,3,11,Loyal
17176,1,306.13,202,2,2,1,5,SomeWhat Loyal
17179,3,711.79,178,4,3,2,9,Loyal
17180,4,796.03,56,4,3,3,10,Loyal
17181,2,239.92000000000002,57,3,1,3,7,SomeWhat Loyal
17183,6,3347.31,8,5,5,5,15,Champion
17186,2,144.0,47,3,1,3,7,SomeWhat Loyal
17187,1,203.95,227,2,1,1,4,Others
17188,7,2474.23,11,5,5,5,15,Champion
17189,2,384.40000000000003,106,3,2,2,7,SomeWhat Loyal
17190,2,444.74,59,3,2,3,8,SomeWhat Loyal
17191,7,2095.13,28,5,5,4,14,Champion
17193,7,1699.3000000000002,36,5,4,3,12,Loyal
17194,2,262.62,274,3,2,1,6,SomeWhat Loyal
17197,1,1013.01,30,2,4,4,10,Loyal
17198,3,692.22,24,4,3,4,11,Loyal
17201,1,342.63,54,2,2,3,7,SomeWhat Loyal
17203,6,3563.85,36,5,5,3,13,Champion
17204,4,1564.56,175,4,4,2,10,Loyal
17205,1,384.08,54,2,2,3,7,SomeWhat Loyal
17206,1,204.24,53,2,1,3,6,SomeWhat Loyal
17211,8,2317.2200000000003,27,5,5,4,14,Champion
17212,1,226.85,253,2,1,1,4,Others
17213,7,2781.23,40,5,5,3,13,Champion
17214,6,1069.1200000000001,60,5,4,3,12,Loyal
17217,1,113.5,234,2,1,1,4,Others
17218,10,1960.72,4,5,4,5,14,Champion
17219,1,114.23,32,2,1,4,7,SomeWhat Loyal
17220,14,3198.25,24,5,5,4,14,Champion
17221,2,335.13,7,3,2,5,10,Loyal
17222,1,354.15,65,2,2,3,7,SomeWhat Loyal
17223,2,426.79,310,3,2,1,6,SomeWhat Loyal
17226,1,393.49,309,2,2,1,5,SomeWhat Loyal
17227,6,939.32,19,5,3,4,12,Loyal
17228,8,1906.09,16,5,4,4,13,Champion
17229,2,318.76,96,3,2,2,7,SomeWhat Loyal
17230,8,3638.41,264,5,5,1,11,Loyal
17231,10,3174.32,12,5,5,5,15,Champion
17232,2,421.52,3,3,2,5,10,Loyal
17233,1,190.88,35,2,1,3,6,SomeWhat Loyal
17234,1,149.89000000000001,183,2,1,1,4,Others
17235,2,550.06,25,3,3,4,10,Loyal
17236,6,916.13,13,5,3,5,13,Champion
17237,2,314.69,11,3,2,5,10,Loyal
17238,17,3744.65,3,5,5,5,15,Champion
17239,1,382.5,313,2,2,1,5,SomeWhat Loyal
17242,2,1135.04,108,3,4,2,9,Loyal
17243,26,8676.85,1,5,5,5,15,Champion
17244,1,954.9,53,2,4,3,9,Loyal
17245,1,171.45,205,2,1,1,4,Others
17247,1,282.19,15,2,2,4,8,SomeWhat Loyal
17248,1,318.65,120,2,2,2,6,SomeWhat Loyal
17250,2,384.52,4,3,2,5,10,Loyal
17251,1,283.28000000000003,363,2,2,1,5,SomeWhat Loyal
17252,2,353.86,117,3,2,2,7,SomeWhat Loyal
17253,1,178.26,18,2,1,4,7,SomeWhat Loyal
17254,2,272.44,5,3,2,5,10,Loyal
17255,2,298.41,41,3,2,3,8,SomeWhat Loyal
17256,2,240.0,107,3,1,2,6,SomeWhat Loyal
17259,2,603.37,148,3,3,2,8,SomeWhat Loyal
17262,5,1253.3600000000001,52,4,4,3,11,Loyal
17263,1,63.440000000000005,208,2,1,1,4,Others
17265,2,562.9,139,3,3,2,8,SomeWhat Loyal
17266,3,310.64,2,4,2,5,11,Loyal
17267,2,317.62,127,3,2,2,7,SomeWhat Loyal
17268,4,763.64,108,4,3,2,9,Loyal
17272,4,2148.63,42,4,5,3,12,Loyal
17274,1,111.97999999999999,35,2,1,3,6,SomeWhat Loyal
17277,2,1065.3500000000001,228,3,4,1,8,SomeWhat Loyal
17278,1,246.04,241,2,1,1,4,Others
17279,1,187.82999999999998,58,2,1,3,6,SomeWhat Loyal
17282,3,1703.41,130,4,4,2,10,Loyal
17284,6,1652.58,60,5,4,3,12,Loyal
17286,1,153.92,22,2,1,4,7,SomeWhat Loyal
17287,7,1064.11,26,5,4,4,13,Champion
17288,7,1419.73,9,5,4,5,14,Champion
17289,3,944.41,32,4,4,4,12,Loyal
17290,2,525.24,4,3,3,5,11,Loyal
17291,1,550.8000000000001,308,2,3,1,6,SomeWhat Loyal
17293,9,1875.1100000000001,8,5,4,5,14,Champion
17295,3,556.95,29,4,3,4,11,Loyal
17297,1,131.78,17,2,1,4,7,SomeWhat Loyal
17298,2,498.42,101,3,3,2,8,SomeWhat Loyal
17299,4,669.11,12,4,3,5,12,Loyal
17301,1,197.63,21,2,1,4,7,SomeWhat Loyal
17302,5,1135.63,15,4,4,4,12,Loyal
17303,1,250.04,361,2,1,1,4,Others
17306,19,8631.31,11,5,5,5,15,Champion
17309,1,82.75,95,2,1,2,5,SomeWhat Loyal
17311,2,1384.85,78,3,4,2,9,Loyal
17312,3,644.3,139,4,3,2,9,Loyal
17313,1,2328.84,31,2,5,4,11,Loyal
17314,8,2527.92,25,5,5,4,14,Champion
17315,38,6292.26,2,5,5,5,15,Champion
17317,3,2600.34,46,4,5,3,12,Loyal
17320,3,1200.6200000000001,100,4,4,2,10,Loyal
17321,2,700.86,8,3,3,5,11,Loyal
17323,7,921.07,15,5,3,4,12,Loyal
17324,4,990.23,18,4,4,4,12,Loyal
17325,1,96.8,280,2,1,1,4,Others
17329,2,523.11,14,3,3,4,10,Loyal
17330,2,363.9,23,3,2,4,9,Loyal
17331,1,175.2,124,2,1,2,5,SomeWhat Loyal
17333,1,494.25,86,2,3,2,7,SomeWhat Loyal
17334,2,307.02,302,3,2,1,6,SomeWhat Loyal
17337,4,2027.8700000000001,151,4,4,2,10,Loyal
17338,8,6643.93,17,5,5,4,14,Champion
17339,2,243.36,94,3,1,2,6,SomeWhat Loyal
17340,11,12353.29,30,5,5,4,14,Champion
17341,3,781.36,157,4,3,2,9,Loyal
17343,1,193.64,355,2,1,1,4,Others
17344,1,160.57,46,2,1,3,6,SomeWhat Loyal
17345,4,537.74,15,4,3,4,11,Loyal
17346,15,2676.56,4,5,5,5,15,Champion
17347,1,228.96,86,2,1,2,5,SomeWhat Loyal
17348,5,1159.52,15,4,4,4,12,Loyal
17349,1,110.75,179,2,1,1,4,Others
17350,4,1286.07,8,4,4,5,13,Champion
17351,3,587.15,36,4,3,3,10,Loyal
17353,2,1740.0,129,3,4,2,9,Loyal
17354,1,1393.06,51,2,4,3,9,Loyal
17356,1,178.22,312,2,1,1,4,Others
17357,2,388.14,24,3,2,4,9,Loyal
17358,2,365.85,303,3,2,1,6,SomeWhat Loyal
17359,1,127.86,11,2,1,5,8,SomeWhat Loyal
17360,3,585.79,17,4,3,4,11,Loyal
17361,3,488.2,49,4,2,3,9,Loyal
17362,2,312.23,239,3,2,1,6,SomeWhat Loyal
17364,11,4481.18,1,5,5,5,15,Champion
17365,8,4801.56,13,5,5,5,15,Champion
17367,1,168.4,238,2,1,1,4,Others
17368,8,1912.67,23,5,4,4,13,Champion
17370,4,446.18,73,4,2,2,8,SomeWhat Loyal
17371,3,423.89,17,4,2,4,10,Loyal
17372,8,1342.68,41,5,4,3,12,Loyal
17373,4,646.92,40,4,3,3,10,Loyal
17374,2,495.77,219,3,3,1,7,SomeWhat Loyal
17375,3,400.1,199,4,2,1,7,SomeWhat Loyal
17376,2,203.2,71,3,1,3,7,SomeWhat Loyal
17377,20,4100.92,24,5,5,4,14,Champion
17379,1,404.66,11,2,2,5,9,Loyal
17381,29,20275.61,9,5,5,5,15,Champion
17382,1,65.4,65,2,1,3,6,SomeWhat Loyal
17383,1,199.29,4,2,1,5,8,SomeWhat Loyal
17384,2,336.4,19,3,2,4,9,Loyal
17385,1,261.11,15,2,2,4,8,SomeWhat Loyal
17386,6,2686.42,8,5,5,5,15,Champion
17387,2,784.11,20,3,3,4,10,Loyal
17388,4,1259.56,78,4,4,2,10,Loyal
17389,34,31833.68,1,5,5,5,15,Champion
17391,2,508.8,164,3,3,2,8,SomeWhat Loyal
17392,2,457.91,307,3,2,1,6,SomeWhat Loyal
17394,1,203.86999999999998,219,2,1,1,4,Others
17396,8,7330.8,39,5,5,3,13,Champion
17397,2,696.41,22,3,3,4,10,Loyal
17398,3,653.38,115,4,3,2,9,Loyal
17400,5,2129.96,126,4,5,2,11,Loyal
17402,13,2633.85,5,5,5,5,15,Champion
17403,1,281.62,36,2,2,3,7,SomeWhat Loyal
17404,15,31906.82,4,5,5,5,15,Champion
17405,3,1031.41,1,4,4,5,13,Champion
17406,3,2200.42,333,4,5,1,10,Loyal
17408,1,32.65,163,2,1,2,5,SomeWhat Loyal
17409,2,771.85,185,3,3,1,7,SomeWhat Loyal
17410,5,1214.72,16,4,4,4,12,Loyal
17411,3,778.94,12,4,3,5,12,Loyal
17412,7,1258.06,3,5,4,5,14,Champion
17414,2,778.0,44,3,3,3,9,Loyal
17415,1,507.84,80,2,3,2,7,SomeWhat Loyal
17416,7,6893.42,30,5,5,4,14,Champion
17418,2,463.46000000000004,42,3,2,3,8,SomeWhat Loyal
17419,12,4226.57,11,5,5,5,15,Champion
17420,3,598.83,50,4,3,3,10,Loyal
17422,6,1979.37,16,5,4,4,13,Champion
17423,2,698.41,46,3,3,3,9,Loyal
17425,2,759.17,19,3,3,4,10,Loyal
17426,6,5037.26,8,5,5,5,15,Champion
17427,1,100.8,72,2,1,2,5,SomeWhat Loyal
17428,28,17256.85,1,5,5,5,15,Champion
17429,3,524.9200000000001,128,4,3,2,9,Loyal
17430,2,265.76,33,3,2,3,8,SomeWhat Loyal
17431,1,403.3,313,2,2,1,5,SomeWhat Loyal
17432,2,365.76,18,3,2,4,9,Loyal
17433,1,303.15999999999997,88,2,2,2,6,SomeWhat Loyal
17434,7,2373.82,2,5,5,5,15,Champion
17436,2,216.29999999999998,2,3,1,5,9,Loyal
17438,1,388.45000000000005,254,2,2,1,5,SomeWhat Loyal
17440,3,186.42000000000002,157,4,1,2,7,SomeWhat Loyal
17442,6,2248.56,37,5,5,3,13,Champion
17443,1,534.24,220,2,3,1,6,SomeWhat Loyal
17444,3,2940.04,148,4,5,2,11,Loyal
17446,2,120.9,177,3,1,2,6,SomeWhat Loyal
17447,2,541.53,40,3,3,3,9,Loyal
17449,7,2520.86,2,5,5,5,15,Champion
17450,46,194550.79,8,5,5,5,15,Champion
17451,7,1721.4,1,5,4,5,14,Champion
17453,2,486.71999999999997,18,3,2,4,9,Loyal
17454,4,517.53,192,4,3,1,8,SomeWhat Loyal
17455,1,131.7,204,2,1,1,4,Others
17456,1,249.86,365,2,1,1,4,Others
17457,5,1737.7,127,4,4,2,10,Loyal
17458,1,316.5,15,2,2,4,8,SomeWhat Loyal
17459,2,657.3,43,3,3,3,9,Loyal
17460,6,622.4300000000001,94,5,3,2,10,Loyal
17461,3,757.46,23,4,3,4,11,Loyal
17462,2,675.69,60,3,3,3,9,Loyal
17463,5,1896.41,16,4,4,4,12,Loyal
17464,1,289.96000000000004,158,2,2,2,6,SomeWhat Loyal
17466,2,763.28,10,3,3,5,11,Loyal
17468,2,137.0,10,3,1,5,9,Loyal
17469,5,1870.97,16,4,4,4,12,Loyal
17470,5,1125.07,45,4,4,3,11,Loyal
17472,3,710.29,191,4,3,1,8,SomeWhat Loyal
17475,1,194.37,79,2,1,2,5,SomeWhat Loyal
17480,1,511.82,78,2,3,2,7,SomeWhat Loyal
17481,4,1255.59,4,4,4,5,13,Champion
17483,3,414.04,65,4,2,3,9,Loyal
17486,1,396.87,261,2,2,1,5,SomeWhat Loyal
17489,2,376.64,59,3,2,3,8,SomeWhat Loyal
17490,7,2092.32,1,5,5,5,15,Champion
17491,10,3558.87,1,5,5,5,15,Champion
17492,1,374.57,248,2,2,1,5,SomeWhat Loyal
17495,2,497.56,8,3,3,5,11,Loyal
17496,1,271.05,359,2,2,1,5,SomeWhat Loyal
17498,1,272.22,76,2,2,2,6,SomeWhat Loyal
17499,1,622.88,290,2,3,1,6,SomeWhat Loyal
17500,3,1138.0,17,4,4,4,12,Loyal
17501,2,288.6,221,3,2,1,6,SomeWhat Loyal
17502,4,689.1,9,4,3,5,12,Loyal
17503,2,558.96,3,3,3,5,11,Loyal
17504,9,2997.0299999999997,206,5,5,1,11,Loyal
17505,2,1145.84,162,3,4,2,9,Loyal
17506,1,302.2,76,2,2,2,6,SomeWhat Loyal
17507,2,605.58,262,3,3,1,7,SomeWhat Loyal
17508,1,387.31,281,2,2,1,5,SomeWhat Loyal
17509,8,6115.14,58,5,5,3,13,Champion
17510,1,308.48,25,2,2,4,8,SomeWhat Loyal
17511,31,91062.38,3,5,5,5,15,Champion
17512,10,2924.9900000000002,29,5,5,4,14,Champion
17513,1,513.2,72,2,3,2,7,SomeWhat Loyal
17514,1,208.65,128,2,1,2,5,SomeWhat Loyal
17515,4,639.02,31,4,3,4,11,Loyal
17516,5,768.08,15,4,3,4,11,Loyal
17517,1,153.94,309,2,1,1,4,Others
17519,6,1844.02,17,5,4,4,13,Champion
17520,1,546.81,54,2,3,3,8,SomeWhat Loyal
17521,3,723.2099999999999,30,4,3,4,11,Loyal
17522,5,1070.71,2,4,4,5,13,Champion
17523,4,652.74,11,4,3,5,12,Loyal
17524,1,145.0,361,2,1,1,4,Others
17525,1,422.70000000000005,360,2,2,1,5,SomeWhat Loyal
17526,4,1195.8999999999999,5,4,4,5,13,Champion
17527,4,939.37,54,4,3,3,10,Loyal
17528,8,3628.5,1,5,5,5,15,Champion
17530,10,2385.0,1,5,5,5,15,Champion
17531,1,296.7,190,2,2,1,5,SomeWhat Loyal
17534,1,223.36,54,2,1,3,6,SomeWhat Loyal
17535,1,164.4,280,2,1,1,4,Others
17536,1,76.5,177,2,1,2,5,SomeWhat Loyal
17537,2,897.62,30,3,3,4,10,Loyal
17538,1,98.42,26,2,1,4,7,SomeWhat Loyal
17540,2,578.9,25,3,3,4,10,Loyal
17542,1,170.75,270,2,1,1,4,Others
17545,3,645.96,43,4,3,3,10,Loyal
17548,1,103.3,234,2,1,1,4,Others
17549,2,148.86,24,3,1,4,8,SomeWhat Loyal
17550,3,267.16,197,4,2,1,7,SomeWhat Loyal
17551,1,306.84,359,2,2,1,5,SomeWhat Loyal
17552,4,930.41,60,4,3,3,10,Loyal
17553,1,1487.6,130,2,4,2,8,SomeWhat Loyal
17554,5,1952.45,1,4,4,5,13,Champion
17555,2,483.26,20,3,2,4,9,Loyal
17556,1,157.9,206,2,1,1,4,Others
17557,3,541.46,14,4,3,4,11,Loyal
17560,4,854.95,95,4,3,2,9,Loyal
17561,1,167.62,19,2,1,4,7,SomeWhat Loyal
17562,7,1122.38,14,5,4,4,13,Champion
17564,3,454.01,24,4,2,4,10,Loyal
17566,2,901.21,8,3,3,5,11,Loyal
17567,8,4331.48,7,5,5,5,15,Champion
17569,1,344.14,332,2,2,1,5,SomeWhat Loyal
17571,4,1498.51,50,4,4,3,11,Loyal
17572,4,226.75000000000003,71,4,1,3,8,SomeWhat Loyal
17573,3,380.6,29,4,2,4,10,Loyal
17574,1,185.65,243,2,1,1,4,Others
17576,19,3622.68,8,5,5,5,15,Champion
17578,1,143.45999999999998,218,2,1,1,4,Others
17579,3,448.90000000000003,5,4,2,5,11,Loyal
17580,3,215.72,253,4,1,1,6,SomeWhat Loyal
17581,25,11045.04,1,5,5,5,15,Champion
17582,1,175.27,236,2,1,1,4,Others
17584,2,1242.3,7,3,4,5,12,Loyal
17585,4,1133.07,109,4,4,2,10,Loyal
17588,3,1240.2,100,4,4,2,10,Loyal
17589,4,2404.17,60,4,5,3,12,Loyal
17590,3,1479.22,2,4,4,5,13,Champion
17591,7,2225.9700000000003,73,5,5,2,12,Loyal
17593,5,3927.34,4,4,5,5,14,Champion
17594,2,993.18,85,3,4,2,9,Loyal
17595,2,388.79,12,3,2,5,10,Loyal
17596,7,2827.93,23,5,5,4,14,Champion
17597,1,2044.3700000000001,214,2,4,1,7,SomeWhat Loyal
17600,1,161.67000000000002,18,2,1,4,7,SomeWhat Loyal
17601,1,116.00999999999999,239,2,1,1,4,Others
17602,6,5102.97,2,5,5,5,15,Champion
17603,1,394.72,78,2,2,2,6,SomeWhat Loyal
17604,2,309.36,217,3,2,1,6,SomeWhat Loyal
17608,2,193.42,33,3,1,3,7,SomeWhat Loyal
17609,5,1112.22,41,4,4,3,11,Loyal
17611,15,3984.22,7,5,5,5,15,Champion
17612,6,2048.45,53,5,4,3,12,Loyal
17613,14,4559.150000000001,23,5,5,4,14,Champion
17614,1,390.07,57,2,2,3,7,SomeWhat Loyal
17615,3,329.6,130,4,2,2,8,SomeWhat Loyal
17616,3,571.1999999999999,174,4,3,2,9,Loyal
17618,3,971.58,6,4,4,5,13,Champion
17619,1,218.52,312,2,1,1,4,Others
17620,1,81.44,60,2,1,3,6,SomeWhat Loyal
17621,3,1379.9,21,4,4,4,12,Loyal
17623,1,527.0500000000001,33,2,3,3,8,SomeWhat Loyal
17624,2,843.48,15,3,3,4,10,Loyal
17625,4,2047.0,18,4,4,4,12,Loyal
17628,1,75.75,81,2,1,2,5,SomeWhat Loyal
17629,8,1814.12,6,5,4,5,14,Champion
17630,2,503.59999999999997,170,3,3,2,8,SomeWhat Loyal
17631,3,528.33,2,4,3,5,12,Loyal
17633,4,1324.84,31,4,4,4,12,Loyal
17634,9,2361.9700000000003,36,5,5,3,13,Champion
17636,1,285.56,19,2,2,4,8,SomeWhat Loyal
17637,2,547.0600000000001,31,3,3,4,10,Loyal
17639,1,108.5,276,2,1,1,4,Others
17640,1,621.66,87,2,3,2,7,SomeWhat Loyal
17642,2,712.29,120,3,3,2,8,SomeWhat Loyal
17643,1,101.55,373,2,1,1,4,Others
17644,11,2895.64,1,5,5,5,15,Champion
17646,3,1008.39,219,4,4,1,9,Loyal
17647,1,133.06,65,2,1,3,6,SomeWhat Loyal
17648,4,1797.5,61,4,4,3,11,Loyal
17649,1,868.49,138,2,3,2,7,SomeWhat Loyal
17650,1,166.08,21,2,1,4,7,SomeWhat Loyal
17651,10,3945.0,12,5,5,5,15,Champion
17652,12,4867.72,25,5,5,4,14,Champion
17653,4,1207.56,37,4,4,3,11,Loyal
17654,1,117.55,277,2,1,1,4,Others
17655,7,2638.94,11,5,5,5,15,Champion
17656,5,1674.69,73,4,4,2,10,Loyal
17658,2,595.42,26,3,3,4,10,Loyal
17659,12,2999.46,17,5,5,4,14,Champion
17660,1,196.0,141,2,1,2,5,SomeWhat Loyal
17663,7,1802.91,26,5,4,4,13,Champion
17664,2,604.64,19,3,3,4,10,Loyal
17666,2,728.16,4,3,3,5,11,Loyal
17667,5,2055.51,66,4,4,3,11,Loyal
17668,2,347.75,1,3,2,5,10,Loyal
17669,7,3406.7200000000003,43,5,5,3,13,Champion
17670,1,205.7,228,2,1,1,4,Others
17671,4,1572.71,16,4,4,4,12,Loyal
17672,2,3178.17,50,3,5,3,11,Loyal
17673,6,1629.12,2,5,4,5,14,Champion
17674,2,551.04,74,3,3,2,8,SomeWhat Loyal
17675,31,20374.28,1,5,5,5,15,Champion
17676,6,1387.68,4,5,4,5,14,Champion
17677,30,16363.23,2,5,5,5,15,Champion
17678,1,298.11,264,2,2,1,5,SomeWhat Loyal
17679,2,1992.1100000000001,53,3,4,3,10,Loyal
17680,1,184.4,24,2,1,4,7,SomeWhat Loyal
17682,6,2474.33,10,5,5,5,15,Champion
17684,1,239.41,44,2,1,3,6,SomeWhat Loyal
17685,7,3191.53,17,5,5,4,14,Champion
17686,7,5739.46,7,5,5,5,15,Champion
17690,15,4757.95,30,5,5,4,14,Champion
17691,2,290.40000000000003,358,3,2,1,6,SomeWhat Loyal
17692,4,740.9399999999999,127,4,3,2,9,Loyal
17693,1,200.47,137,2,1,2,5,SomeWhat Loyal
17694,1,283.12,142,2,2,2,6,SomeWhat Loyal
17695,2,765.34,132,3,3,2,8,SomeWhat Loyal
17696,8,2285.71,38,5,5,3,13,Champion
17697,1,338.95,236,2,2,1,5,SomeWhat Loyal
17698,1,154.95,261,2,1,1,4,Others
17700,4,2534.64,17,4,5,4,13,Champion
17701,1,417.95,253,2,2,1,5,SomeWhat Loyal
17702,4,1824.37,30,4,4,4,12,Loyal
17703,3,798.74,35,4,3,3,10,Loyal
17704,2,885.19,169,3,3,2,8,SomeWhat Loyal
17705,9,1823.52,3,5,4,5,14,Champion
17706,17,10504.49,4,5,5,5,15,Champion
17707,2,152.4,185,3,1,1,5,SomeWhat Loyal
17708,2,267.08,188,3,2,1,6,SomeWhat Loyal
17709,1,137.45,170,2,1,2,5,SomeWhat Loyal
17711,2,385.1,11,3,2,5,10,Loyal
17712,1,522.91,45,2,3,3,8,SomeWhat Loyal
17714,1,153.0,321,2,1,1,4,Others
17715,1,326.4,201,2,2,1,5,SomeWhat Loyal
17716,11,5655.99,23,5,5,4,14,Champion
17718,1,139.35,232,2,1,1,4,Others
17719,15,5396.04,38,5,5,3,13,Champion
17720,4,1195.94,26,4,4,4,12,Loyal
17722,4,2424.04,96,4,5,2,11,Loyal
17723,6,3276.4000000000005,127,5,5,2,12,Loyal
17724,3,1033.0,71,4,4,3,11,Loyal
17725,11,3439.08,16,5,5,4,14,Champion
17727,1,1060.25,15,2,4,4,10,Loyal
17728,3,2876.01,4,4,5,5,14,Champion
17730,13,5298.4800000000005,3,5,5,5,15,Champion
17731,4,1240.11,79,4,4,2,10,Loyal
17732,1,303.97,373,2,2,1,5,SomeWhat Loyal
17733,2,692.19,39,3,3,3,9,Loyal
17734,3,700.63,54,4,3,3,10,Loyal
17735,19,13110.02,2,5,5,5,15,Champion
17736,3,377.44,9,4,2,5,11,Loyal
17737,2,168.24,9,3,1,5,9,Loyal
17738,4,1879.05,19,4,4,4,12,Loyal
17739,7,2791.35,12,5,5,5,15,Champion
17742,2,355.11,113,3,2,2,7,SomeWhat Loyal
17744,6,2322.4,4,5,5,5,15,Champion
17746,1,110.25,240,2,1,1,4,Others
17747,1,71.4,113,2,1,2,5,SomeWhat Loyal
17749,2,674.52,178,3,3,2,8,SomeWhat Loyal
17750,9,1797.57,5,5,4,5,14,Champion
17752,1,80.64,359,2,1,1,4,Others
17754,5,1772.26,1,4,4,5,13,Champion
17757,30,5605.29,1,5,5,5,15,Champion
17758,8,3456.7000000000003,19,5,5,4,14,Champion
17759,3,834.99,17,4,3,4,11,Loyal
17760,2,287.59,22,3,2,4,9,Loyal
17761,1,712.78,33,2,3,3,8,SomeWhat Loyal
17763,1,15.0,263,2,1,1,4,Others
17764,2,818.8199999999999,51,3,3,3,9,Loyal
17765,3,371.88,159,4,2,2,8,SomeWhat Loyal
17767,1,271.2,15,2,2,4,8,SomeWhat Loyal
17768,3,2273.1800000000003,8,4,5,5,14,Champion
17769,10,3997.98,13,5,5,5,15,Champion
17770,5,1143.27,199,4,4,1,9,Loyal
17771,2,245.81,57,3,1,3,7,SomeWhat Loyal
17772,2,182.77,11,3,1,5,9,Loyal
17774,4,1225.41,97,4,4,2,10,Loyal
17775,1,56.4,255,2,1,1,4,Others
17777,3,665.86,25,4,3,4,11,Loyal
17779,3,658.57,21,4,3,4,11,Loyal
17781,2,188.02,159,3,1,2,6,SomeWhat Loyal
17783,2,283.47,72,3,2,2,7,SomeWhat Loyal
17785,1,131.94,53,2,1,3,6,SomeWhat Loyal
17786,2,278.74,85,3,2,2,7,SomeWhat Loyal
17787,4,1865.19,153,4,4,2,10,Loyal
17788,2,1117.9,74,3,4,2,9,Loyal
17789,1,225.9,281,2,1,1,4,Others
17790,14,1965.55,27,5,4,4,13,Champion
17791,1,106.1,30,2,1,4,7,SomeWhat Loyal
17793,1,323.04,25,2,2,4,8,SomeWhat Loyal
17795,2,350.39,180,3,2,1,6,SomeWhat Loyal
17796,4,697.9,40,4,3,3,10,Loyal
17797,3,780.43,22,4,3,4,11,Loyal
17799,10,3055.93,22,5,5,4,14,Champion
17800,9,1199.01,37,5,4,3,12,Loyal
17802,3,1285.04,82,4,4,2,10,Loyal
17805,1,512.31,74,2,3,2,7,SomeWhat Loyal
17806,1,546.04,11,2,3,5,10,Loyal
17809,12,5411.91,16,5,5,4,14,Champion
17811,39,7837.7300000000005,4,5,5,5,15,Champion
17812,4,732.16,13,4,3,5,12,Loyal
17813,5,1770.8799999999999,14,4,4,4,12,Loyal
17816,4,36.56,37,4,1,3,8,SomeWhat Loyal
17817,3,387.68,4,4,2,5,11,Loyal
17819,7,3704.87,72,5,5,2,12,Loyal
17824,1,298.4,51,2,2,3,7,SomeWhat Loyal
17827,5,1995.46,5,4,4,5,13,Champion
17828,4,1820.09,23,4,4,4,12,Loyal
17829,1,889.24,299,2,3,1,6,SomeWhat Loyal
17830,3,398.7,2,4,2,5,11,Loyal
17831,1,35.400000000000006,33,2,1,3,6,SomeWhat Loyal
17832,1,155.37,50,2,1,3,6,SomeWhat Loyal
17835,3,350.64,3,4,2,5,11,Loyal
17836,1,110.21000000000001,47,2,1,3,6,SomeWhat Loyal
17837,8,1593.38,42,5,4,3,12,Loyal
17838,5,2779.3,27,4,5,4,13,Champion
17839,1,338.8,42,2,2,3,7,SomeWhat Loyal
17841,124,40991.57,2,5,5,5,15,Champion
17843,1,205.48,303,2,1,1,4,Others
17844,1,51.559999999999995,107,2,1,2,5,SomeWhat Loyal
17846,1,2033.1,85,2,4,2,8,SomeWhat Loyal
17848,9,901.1999999999999,81,5,3,2,10,Loyal
17849,4,605.8000000000001,218,4,3,1,8,SomeWhat Loyal
17850,34,5391.21,372,5,5,1,11,Loyal
17852,2,114.34,12,3,1,5,9,Loyal
17854,2,311.26,185,3,2,1,6,SomeWhat Loyal
17855,1,208.97,373,2,1,1,4,Others
17856,4,1418.03,2,4,4,5,13,Champion
17857,23,26879.04,4,5,5,5,15,Champion
17858,12,5155.66,6,5,5,5,15,Champion
17859,1,148.21,305,2,1,1,4,Others
17860,1,252.8,369,2,2,1,5,SomeWhat Loyal
17861,8,2100.8,3,5,5,5,15,Champion
17862,1,330.9,324,2,2,1,5,SomeWhat Loyal
17863,6,3160.0,59,5,5,3,13,Champion
17864,3,597.5,13,4,3,5,12,Loyal
17865,20,10526.32,31,5,5,4,14,Champion
17866,1,329.65,143,2,2,2,6,SomeWhat Loyal
17867,6,1197.1000000000001,30,5,4,4,13,Champion
17869,5,428.18,107,4,2,2,8,SomeWhat Loyal
17870,12,1894.35,2,5,4,5,14,Champion
17871,1,155.9,205,2,1,1,4,Others
17873,5,1859.16,80,4,4,2,10,Loyal
17874,6,683.46,185,5,3,1,9,Loyal
17877,1,237.61,170,2,1,2,5,SomeWhat Loyal
17878,1,379.45,44,2,2,3,7,SomeWhat Loyal
17879,1,178.51999999999998,174,2,1,2,5,SomeWhat Loyal
17880,1,458.92,365,2,2,1,5,SomeWhat Loyal
17881,1,133.35000000000002,304,2,1,1,4,Others
17883,4,671.77,3,4,3,5,12,Loyal
17884,4,717.45,4,4,3,5,12,Loyal
17885,1,190.19,12,2,1,5,8,SomeWhat Loyal
17886,3,899.61,32,4,3,4,11,Loyal
17887,1,111.35,129,2,1,2,5,SomeWhat Loyal
17888,8,726.05,21,5,3,4,12,Loyal
17889,2,203.87,212,3,1,1,5,SomeWhat Loyal
17890,2,602.09,323,3,3,1,7,SomeWhat Loyal
17891,1,203.85999999999999,162,2,1,2,5,SomeWhat Loyal
17892,3,244.1,56,4,1,3,8,SomeWhat Loyal
17893,1,112.25,225,2,1,1,4,Others
17894,8,1119.81,72,5,4,2,11,Loyal
17895,1,98.0,44,2,1,3,6,SomeWhat Loyal
17896,1,256.32,23,2,2,4,8,SomeWhat Loyal
17897,3,566.6,173,4,3,2,9,Loyal
17898,2,152.06,85,3,1,2,6,SomeWhat Loyal
17899,1,155.8,159,2,1,2,5,SomeWhat Loyal
17900,2,112.19999999999999,190,3,1,1,5,SomeWhat Loyal
17901,1,110.38,29,2,1,4,7,SomeWhat Loyal
17904,1,191.67,21,2,1,4,7,SomeWhat Loyal
17905,4,800.24,71,4,3,3,10,Loyal
17906,1,72.9,247,2,1,1,4,Others
17908,1,243.28,374,2,1,1,4,Others
17911,1,366.23,9,2,2,5,9,Loyal
17912,5,311.01,310,4,2,1,7,SomeWhat Loyal
17913,2,411.6,59,3,2,3,8,SomeWhat Loyal
17914,1,336.43,4,2,2,5,9,Loyal
17917,3,341.28,45,4,2,3,9,Loyal
17919,1,1304.04,88,2,4,2,8,SomeWhat Loyal
17920,17,4204.1,4,5,5,5,15,Champion
17921,4,826.52,64,4,3,3,10,Loyal
17923,1,207.50000000000003,282,2,1,1,4,Others
17924,7,2962.5,12,5,5,5,15,Champion
17925,1,244.08,373,2,1,1,4,Others
17926,2,397.29,133,3,2,2,7,SomeWhat Loyal
17928,2,212.54,45,3,1,3,7,SomeWhat Loyal
17929,4,843.0,11,4,3,5,12,Loyal
17930,5,1740.48,36,4,4,3,11,Loyal
17931,2,408.36,134,3,2,2,7,SomeWhat Loyal
17932,3,1331.57,29,4,4,4,12,Loyal
17934,2,704.25,52,3,3,3,9,Loyal
17935,2,145.79,138,3,1,2,6,SomeWhat Loyal
17936,1,389.84,5,2,2,5,9,Loyal
17937,7,4301.22,9,5,5,5,15,Champion
17939,1,99.14,160,2,1,2,5,SomeWhat Loyal
17940,10,4106.4400000000005,49,5,5,3,13,Champion
17941,1,304.56,131,2,2,2,6,SomeWhat Loyal
17942,1,77.50000000000001,8,2,1,5,8,SomeWhat Loyal
17946,2,149.57999999999998,233,3,1,1,5,SomeWhat Loyal
17947,1,176.68,37,2,1,3,6,SomeWhat Loyal
17948,1,358.56000000000006,147,2,2,2,6,SomeWhat Loyal
17949,45,58510.48,1,5,5,5,15,Champion
17950,3,482.2,72,4,2,2,8,SomeWhat Loyal
17951,3,1008.5400000000001,40,4,4,3,11,Loyal
17954,12,2332.72,5,5,5,5,15,Champion
17955,4,557.3,199,4,3,1,8,SomeWhat Loyal
17956,1,12.75,249,2,1,1,4,Others
17957,1,111.68,66,2,1,3,6,SomeWhat Loyal
17958,1,508.4599999999999,117,2,3,2,7,SomeWhat Loyal
17960,1,73.78,171,2,1,2,5,SomeWhat Loyal
17961,39,1296.44,21,5,4,4,13,Champion
17962,1,102.83,142,2,1,2,5,SomeWhat Loyal
17964,2,471.7,32,3,2,4,9,Loyal
17965,14,2622.57,38,5,5,3,13,Champion
17966,5,1098.43,38,4,4,3,11,Loyal
17967,1,123.07,372,2,1,1,4,Others
17968,1,277.35,374,2,2,1,5,SomeWhat Loyal
17969,2,228.2,166,3,1,2,6,SomeWhat Loyal
17970,1,582.59,211,2,3,1,6,SomeWhat Loyal
17972,1,136.04,242,2,1,1,4,Others
17973,1,337.04,52,2,2,3,7,SomeWhat Loyal
17974,3,740.79,25,4,3,4,11,Loyal
17975,13,4488.81,15,5,5,4,14,Champion
17976,1,353.19,372,2,2,1,5,SomeWhat Loyal
17977,1,288.14,29,2,2,4,8,SomeWhat Loyal
17978,1,300.91999999999996,365,2,2,1,5,SomeWhat Loyal
17979,4,757.71,36,4,3,3,10,Loyal
17980,3,811.45,166,4,3,2,9,Loyal
17984,1,152.68,145,2,1,2,5,SomeWhat Loyal
17985,1,634.95,22,2,3,4,9,Loyal
17986,1,20.8,56,2,1,3,6,SomeWhat Loyal
17987,1,198.57,185,2,1,1,4,Others
17988,7,201.12,12,5,1,5,11,Loyal
17990,3,630.84,237,4,3,1,8,SomeWhat Loyal
17991,2,93.35,225,3,1,1,5,SomeWhat Loyal
17994,4,678.49,122,4,3,2,9,Loyal
17995,1,76.1,282,2,1,1,4,Others
17997,8,1970.6699999999998,74,5,4,2,11,Loyal
17999,2,382.06,37,3,2,3,8,SomeWhat Loyal
18001,2,417.23,12,3,2,5,10,Loyal
18004,1,169.47,362,2,1,1,4,Others
18005,2,249.72,4,3,1,5,9,Loyal
18006,1,444.68,23,2,2,4,8,SomeWhat Loyal
18008,9,2116.19,70,5,5,3,13,Champion
18009,1,257.34,235,2,2,1,5,SomeWhat Loyal
18010,1,174.8,257,2,1,1,4,Others
18011,1,102.78999999999999,373,2,1,1,4,Others
18013,2,187.29,155,3,1,2,6,SomeWhat Loyal
18014,1,166.42,28,2,1,4,7,SomeWhat Loyal
18015,1,120.03,4,2,1,5,8,SomeWhat Loyal
18016,5,1483.56,32,4,4,4,12,Loyal
18017,3,523.0,81,4,3,2,9,Loyal
18018,2,122.14,108,3,1,2,6,SomeWhat Loyal
18019,1,38.45,52,2,1,3,6,SomeWhat Loyal
18022,1,668.11,36,2,3,3,8,SomeWhat Loyal
18024,2,389.78,153,3,2,2,7,SomeWhat Loyal
18027,1,115.31,99,2,1,2,5,SomeWhat Loyal
18030,2,230.64999999999998,4,3,1,5,9,Loyal
18032,1,73.5,334,2,1,1,4,Others
18033,1,97.97,65,2,1,3,6,SomeWhat Loyal
18034,2,422.88,22,3,2,4,9,Loyal
18035,3,730.4,36,4,3,3,10,Loyal
18036,3,405.62,32,4,2,4,10,Loyal
18037,6,70.02,154,5,1,2,8,SomeWhat Loyal
18040,2,357.20000000000005,19,3,2,4,9,Loyal
18041,21,4183.39,12,5,5,5,15,Champion
18042,1,165.04999999999998,54,2,1,3,6,SomeWhat Loyal
18043,3,559.51,25,4,3,4,11,Loyal
18044,10,2088.6,4,5,5,5,15,Champion
18045,1,189.4,45,2,1,3,6,SomeWhat Loyal
18048,2,172.29000000000002,203,3,1,1,5,SomeWhat Loyal
18050,1,74.4,359,2,1,1,4,Others
18053,1,300.02,71,2,2,3,7,SomeWhat Loyal
18055,10,6784.1900000000005,7,5,5,5,15,Champion
18056,1,363.65,288,2,2,1,5,SomeWhat Loyal
18058,1,170.16,10,2,1,5,8,SomeWhat Loyal
18059,3,306.46,23,4,2,4,10,Loyal
18061,10,2119.41,22,5,5,4,14,Champion
18062,3,720.52,173,4,3,2,9,Loyal
18064,2,814.0,133,3,3,2,8,SomeWhat Loyal
18065,14,2392.83,6,5,5,5,15,Champion
18066,1,318.0,75,2,2,2,6,SomeWhat Loyal
18067,1,396.33,40,2,2,3,7,SomeWhat Loyal
18068,1,101.69999999999999,289,2,1,1,4,Others
18069,5,2036.67,26,4,4,4,12,Loyal
18071,2,453.0,258,3,2,1,6,SomeWhat Loyal
18072,1,247.44,186,2,1,1,4,Others
18073,12,3877.5200000000004,114,5,5,2,12,Loyal
18074,1,489.6,374,2,2,1,5,SomeWhat Loyal
18075,10,2611.75,23,5,5,4,14,Champion
18077,11,2633.0099999999998,8,5,5,5,15,Champion
18078,2,336.13,217,3,2,1,6,SomeWhat Loyal
18079,4,3651.97,45,4,5,3,12,Loyal
18080,2,1231.5,19,3,4,4,11,Loyal
18081,3,343.45,36,4,2,3,9,Loyal
18082,1,703.37,26,2,3,4,9,Loyal
18084,1,90.47999999999999,16,2,1,4,7,SomeWhat Loyal
18085,2,689.95,330,3,3,1,7,SomeWhat Loyal
18086,1,101.34,274,2,1,1,4,Others
18087,2,4055.7199999999993,98,3,5,2,10,Loyal
18088,1,167.67000000000002,61,2,1,3,6,SomeWhat Loyal
18092,11,9068.26,2,5,5,5,15,Champion
18093,4,2106.52,93,4,5,2,11,Loyal
18094,7,3017.3,82,5,5,2,12,Loyal
18095,2,580.0500000000001,313,3,3,1,7,SomeWhat Loyal
18096,3,911.15,12,4,3,5,12,Loyal
18097,6,2697.8,8,5,5,5,15,Champion
18099,1,168.31,127,2,1,2,5,SomeWhat Loyal
18101,2,223.65,11,3,1,5,9,Loyal
18102,60,259657.3,1,5,5,5,15,Champion
18104,1,754.64,37,2,3,3,8,SomeWhat Loyal
18105,1,113.48000000000002,38,2,1,3,6,SomeWhat Loyal
18106,1,430.7,330,2,2,1,5,SomeWhat Loyal
18108,1,271.0,254,2,2,1,5,SomeWhat Loyal
18109,26,8052.97,2,5,5,5,15,Champion
18110,1,236.3,20,2,1,4,7,SomeWhat Loyal
18112,2,352.69,12,3,2,5,10,Loyal
18113,1,76.32000000000001,369,2,1,1,4,Others
18114,1,220.1,290,2,1,1,4,Others
18116,8,1418.03,68,5,4,3,12,Loyal
18117,1,320.72,26,2,2,4,8,SomeWhat Loyal
18118,26,5653.82,11,5,5,5,15,Champion
18119,1,181.12,368,2,1,1,4,Others
18120,1,111.15,214,2,1,1,4,Others
18121,2,673.1,149,3,3,2,8,SomeWhat Loyal
18122,6,1826.21,8,5,4,5,14,Champion
18123,2,589.4399999999999,24,3,3,4,10,Loyal
18125,4,1142.99,30,4,4,4,12,Loyal
18126,1,206.82999999999998,61,2,1,3,6,SomeWhat Loyal
18127,3,348.73,19,4,2,4,10,Loyal
18129,1,112.55000000000001,243,2,1,1,4,Others
18130,3,1059.39,15,4,4,4,12,Loyal
18133,1,931.4999999999999,212,2,3,1,6,SomeWhat Loyal
18135,5,681.9100000000001,29,4,3,4,11,Loyal
18136,3,784.33,63,4,3,3,10,Loyal
18138,1,152.65,295,2,1,1,4,Others
18139,6,8438.34,18,5,5,4,14,Champion
18142,2,1019.52,157,3,4,2,9,Loyal
18143,2,1000.16,117,3,4,2,9,Loyal
18144,12,2888.75,8,5,5,5,15,Champion
18145,4,2861.55,13,4,5,5,14,Champion
18146,2,160.35000000000002,141,3,1,2,6,SomeWhat Loyal
18147,2,179.33999999999997,46,3,1,3,7,SomeWhat Loyal
18149,3,612.0799999999999,51,4,3,3,10,Loyal
18150,3,566.58,32,4,3,4,11,Loyal
18151,2,653.35,135,3,3,2,8,SomeWhat Loyal
18154,2,399.19,3,3,2,5,10,Loyal
18155,3,371.62,75,4,2,2,8,SomeWhat Loyal
18156,2,734.94,13,3,3,5,11,Loyal
18158,2,453.4,9,3,2,5,10,Loyal
18159,1,530.15,301,2,3,1,6,SomeWhat Loyal
18160,2,638.0600000000001,57,3,3,3,9,Loyal
18161,5,1618.69,15,4,4,4,12,Loyal
18164,1,399.65000000000003,37,2,2,3,7,SomeWhat Loyal
18165,1,302.46000000000004,177,2,2,2,6,SomeWhat Loyal
18167,3,1384.8600000000001,23,4,4,4,12,Loyal
18168,6,1169.94,176,5,4,2,11,Loyal
18169,1,202.65,61,2,1,3,6,SomeWhat Loyal
18170,3,980.31,33,4,4,3,11,Loyal
18171,5,1231.31,59,4,4,3,11,Loyal
18172,20,7561.68,15,5,5,4,14,Champion
18173,4,2106.84,87,4,5,2,11,Loyal
18174,1,104.0,7,2,1,5,8,SomeWhat Loyal
18176,1,476.35,358,2,2,1,5,SomeWhat Loyal
18177,6,1341.42,31,5,4,4,13,Champion
18178,4,1590.81,129,4,4,2,10,Loyal
18179,6,1793.17,9,5,4,5,14,Champion
18180,6,1843.75,5,5,4,5,14,Champion
18181,1,382.8,24,2,2,4,8,SomeWhat Loyal
18183,2,632.07,227,3,3,1,7,SomeWhat Loyal
18184,1,49.8,15,2,1,4,7,SomeWhat Loyal
18185,1,304.25,249,2,2,1,5,SomeWhat Loyal
18188,3,2001.04,15,4,4,4,12,Loyal
18189,2,1090.24,78,3,4,2,9,Loyal
18190,2,284.46000000000004,192,3,2,1,6,SomeWhat Loyal
18191,1,207.79999999999998,262,2,1,1,4,Others
18192,1,957.97,72,2,4,2,8,SomeWhat Loyal
18193,1,243.76,165,2,1,2,5,SomeWhat Loyal
18194,1,973.8399999999999,82,2,4,2,8,SomeWhat Loyal
18196,2,689.13,95,3,3,2,8,SomeWhat Loyal
18198,17,5425.56,4,5,5,5,15,Champion
18200,1,163.8,106,2,1,2,5,SomeWhat Loyal
18202,3,1396.99,200,4,4,1,9,Loyal
18203,1,160.42000000000002,157,2,1,2,5,SomeWhat Loyal
18204,3,1993.7,71,4,4,3,11,Loyal
18205,2,517.36,36,3,3,3,9,Loyal
18209,1,139.10000000000002,29,2,1,4,7,SomeWhat Loyal
18210,6,2621.38,2,5,5,5,15,Champion
18211,5,600.07,26,4,3,4,11,Loyal
18212,1,248.42,326,2,1,1,4,Others
18213,1,232.48000000000002,237,2,1,1,4,Others
18215,1,299.34000000000003,89,2,2,2,6,SomeWhat Loyal
18216,1,481.75,31,2,2,4,8,SomeWhat Loyal
18217,2,621.75,29,3,3,4,10,Loyal
18218,2,662.08,211,3,3,1,7,SomeWhat Loyal
18219,10,2069.77,3,5,5,5,15,Champion
18220,1,305.28000000000003,227,2,2,1,5,SomeWhat Loyal
18221,5,1041.61,22,4,4,4,12,Loyal
18222,1,443.0,93,2,2,2,6,SomeWhat Loyal
18223,14,6484.54,5,5,5,5,15,Champion
18224,1,158.95000000000002,264,2,1,1,4,Others
18225,12,5509.12,3,5,5,5,15,Champion
18226,11,5228.05,44,5,5,3,13,Champion
18227,1,93.75,218,2,1,1,4,Others
18228,2,779.9,57,3,3,3,9,Loyal
18229,20,7276.900000000001,12,5,5,5,15,Champion
18230,7,2810.2000000000003,9,5,5,5,15,Champion
18231,5,2083.27,192,4,5,1,10,Loyal
18232,4,592.97,82,4,3,2,9,Loyal
18233,1,440.0,326,2,2,1,5,SomeWhat Loyal
18235,3,1796.48,72,4,4,2,10,Loyal
18236,6,882.24,30,5,3,4,12,Loyal
18237,5,987.1,3,4,4,5,13,Champion
18239,5,1561.6100000000001,219,4,4,1,9,Loyal
18240,1,422.58,46,2,2,3,7,SomeWhat Loyal
18241,17,2073.09,10,5,5,5,15,Champion
18242,4,2232.4900000000002,72,4,5,2,11,Loyal
18245,7,2567.06,7,5,5,5,15,Champion
18246,2,596.1,24,3,3,4,10,Loyal
18248,2,804.02,123,3,3,2,8,SomeWhat Loyal
18249,1,95.34,17,2,1,4,7,SomeWhat Loyal
18250,1,349.27,310,2,2,1,5,SomeWhat Loyal
18251,1,4314.72,87,2,5,2,9,Loyal
18252,2,526.67,51,3,3,3,9,Loyal
18255,1,103.3,89,2,1,2,5,SomeWhat Loyal
18257,8,2337.63,39,5,5,3,13,Champion
18259,3,2338.6000000000004,25,4,5,4,13,Champion
18260,6,2643.2000000000003,173,5,5,2,12,Loyal
18261,2,324.24,43,3,2,3,8,SomeWhat Loyal
18262,1,149.48,140,2,1,2,5,SomeWhat Loyal
18263,3,1213.1599999999999,26,4,4,4,12,Loyal
18265,2,801.51,72,3,3,2,8,SomeWhat Loyal
18268,1,25.5,134,2,1,2,5,SomeWhat Loyal
18269,1,168.6,366,2,1,1,4,Others
18270,2,283.15,38,3,2,3,8,SomeWhat Loyal
18272,6,3078.58,3,5,5,5,15,Champion
18273,3,204.0,2,4,1,5,10,Loyal
18274,1,175.92,30,2,1,4,7,SomeWhat Loyal
18276,1,335.86,44,2,2,3,7,SomeWhat Loyal
18277,1,110.38,58,2,1,3,6,SomeWhat Loyal
18278,1,173.9,74,2,1,2,5,SomeWhat Loyal
18280,1,180.60000000000002,278,2,1,1,4,Others
18281,1,80.82,181,2,1,1,4,Others
18282,2,178.05,8,3,1,5,9,Loyal
18283,16,2094.88,4,5,5,5,15,Champion
18287,3,1837.28,43,4,4,3,11,Loyal
